GEO_ID,GEOID_short,NAME,NAME,total_housing_unit,owner_occupied,renter_occupied
1600000US0600135,0600135,"Acalanes Ridge CDP, California",Acalanes Ridge CDP,875,788,87
1600000US0600156,0600156,"Acampo CDP, California",Acampo CDP,261,109,152
1600000US0600212,0600212,"Acton CDP, California",Acton CDP,7043,6416,627
1600000US0600296,0600296,"Adelanto city, California",Adelanto city,31469,17761,13708
1600000US0600310,0600310,"Adin CDP, California",Adin CDP,180,116,64
1600000US0600394,0600394,"Agoura Hills city, California",Agoura Hills city,20157,16135,4022
1600000US0600450,0600450,"Agua Dulce CDP, California",Agua Dulce CDP,3494,3084,410
1600000US0600464,0600464,"Aguanga CDP, California",Aguanga CDP,696,425,271
1600000US0600478,0600478,"Ahwahnee CDP, California",Ahwahnee CDP,2256,1434,822
1600000US0600535,0600535,"Airport CDP, California",Airport CDP,1276,450,826
1600000US0600562,0600562,"Alameda city, California",Alameda city,78693,42250,36443
1600000US0600618,0600618,"Alamo CDP, California",Alamo CDP,13818,12890,928
1600000US0600674,0600674,"Albany city, California",Albany city,20084,10055,10029
1600000US0600716,0600716,"Albion CDP, California",Albion CDP,113,113,0
1600000US0600786,0600786,"Alderpoint CDP, California",Alderpoint CDP,26,26,0
1600000US0600884,0600884,"Alhambra city, California",Alhambra city,83723,34101,49622
1600000US0600898,0600898,"Alhambra Valley CDP, California",Alhambra Valley CDP,1051,998,53
1600000US0600947,0600947,"Aliso Viejo city, California",Aliso Viejo city,49968,30363,19605
1600000US0600982,0600982,"Alleghany CDP, California",Alleghany CDP,99,99,0
1600000US0600996,0600996,"Allendale CDP, California",Allendale CDP,1421,1320,101
1600000US0601010,0601010,"Allensworth CDP, California",Allensworth CDP,596,274,322
1600000US0601094,0601094,"Almanor CDP, California",Almanor CDP,0,0,0
1600000US0601150,0601150,"Alondra Park CDP, California",Alondra Park CDP,7965,4272,3693
1600000US0601164,0601164,"Alpaugh CDP, California",Alpaugh CDP,869,189,680
1600000US0601192,0601192,"Alpine CDP, California",Alpine CDP,14757,10928,3829
1600000US0601228,0601228,"Alpine Village CDP, California",Alpine Village CDP,142,114,28
1600000US0601276,0601276,"Alta CDP, California",Alta CDP,681,628,53
1600000US0601290,0601290,"Altadena CDP, California",Altadena CDP,42454,30024,12430
1600000US0601358,0601358,"Alta Sierra CDP (Kern County), California",Alta Sierra CDP (Kern County),111,97,14
1600000US0601360,0601360,"Alta Sierra CDP (Nevada County), California",Alta Sierra CDP (Nevada County),7600,6969,631
1600000US0601416,0601416,"Alto CDP, California",Alto CDP,818,371,447
1600000US0601444,0601444,"Alturas city, California",Alturas city,2521,1631,890
1600000US0601458,0601458,"Alum Rock CDP, California",Alum Rock CDP,11449,8363,3086
1600000US0601514,0601514,"Amador City city, California",Amador City city,153,57,96
1600000US0601518,0601518,"Amador Pines CDP, California",Amador Pines CDP,992,955,37
1600000US0601640,0601640,"American Canyon city, California",American Canyon city,20175,15577,4598
1600000US0601651,0601651,"Amesti CDP, California",Amesti CDP,3218,2610,608
1600000US0602000,0602000,"Anaheim city, California",Anaheim city,348146,156411,191735
1600000US0602028,0602028,"Anchor Bay CDP, California",Anchor Bay CDP,326,191,135
1600000US0602042,0602042,"Anderson city, California",Anderson city,10466,5239,5227
1600000US0602112,0602112,"Angels city, California",Angels city,3889,2222,1667
1600000US0602168,0602168,"Angwin CDP, California",Angwin CDP,2278,1235,1043
1600000US0602210,0602210,"Antelope CDP, California",Antelope CDP,48356,32067,16289
1600000US0602252,0602252,"Antioch city, California",Antioch city,110901,64814,46087
1600000US0602294,0602294,"Anza CDP, California",Anza CDP,2101,1612,489
1600000US0602364,0602364,"Apple Valley town, California",Apple Valley town,72815,45399,27416
1600000US0602378,0602378,"Aptos CDP, California",Aptos CDP,6245,4845,1400
1600000US0602382,0602382,"Aptos Hills-Larkin Valley CDP, California",Aptos Hills-Larkin Valley CDP,1397,1277,120
1600000US0602420,0602420,"Arbuckle CDP, California",Arbuckle CDP,3368,2314,1054
1600000US0602462,0602462,"Arcadia city, California",Arcadia city,56384,34870,21514
1600000US0602476,0602476,"Arcata city, California",Arcata city,16493,5408,11085
1600000US0602553,0602553,"Arden-Arcade CDP, California",Arden-Arcade CDP,92879,39760,53119
1600000US0602700,0602700,"Armona CDP, California",Armona CDP,4433,2662,1771
1600000US0602770,0602770,"Arnold CDP, California",Arnold CDP,2099,1705,394
1600000US0602812,0602812,"Aromas CDP, California",Aromas CDP,2609,1966,643
1600000US0602868,0602868,"Arroyo Grande city, California",Arroyo Grande city,17697,11781,5916
1600000US0602896,0602896,"Artesia city, California",Artesia city,16015,8397,7618
1600000US0602910,0602910,"Artois CDP, California",Artois CDP,236,102,134
1600000US0602924,0602924,"Arvin city, California",Arvin city,21102,10677,10425
1600000US0602980,0602980,"Ashland CDP, California",Ashland CDP,23400,8376,15024
1600000US0603026,0603026,"Aspen Springs CDP, California",Aspen Springs CDP,56,40,16
1600000US0603064,0603064,"Atascadero city, California",Atascadero city,30075,19741,10334
1600000US0603092,0603092,"Atherton town, California",Atherton town,6485,5862,623
1600000US0603162,0603162,"Atwater city, California",Atwater city,30195,15479,14716
1600000US0603190,0603190,"Auberry CDP, California",Auberry CDP,3275,2627,648
1600000US0603204,0603204,"Auburn city, California",Auburn city,13785,8578,5207
1600000US0603205,0603205,"Auburn Lake Trails CDP, California",Auburn Lake Trails CDP,3495,3000,495
1600000US0603209,0603209,"August CDP, California",August CDP,7933,4144,3789
1600000US0603274,0603274,"Avalon city, California",Avalon city,3711,1128,2583
1600000US0603302,0603302,"Avenal city, California",Avenal city,10305,4970,5335
1600000US0603316,0603316,"Avery CDP, California",Avery CDP,444,271,173
1600000US0603330,0603330,"Avila Beach CDP, California",Avila Beach CDP,1455,1130,325
1600000US0603344,0603344,"Avocado Heights CDP, California",Avocado Heights CDP,13719,10280,3439
1600000US0603386,0603386,"Azusa city, California",Azusa city,44353,22816,21537
1600000US0603512,0603512,"Baker CDP, California",Baker CDP,596,171,425
1600000US0603526,0603526,"Bakersfield city, California",Bakersfield city,375470,229340,146130
1600000US0603546,0603546,"Bakersfield Country Club CDP, California",Bakersfield Country Club CDP,1486,1418,68
1600000US0603666,0603666,"Baldwin Park city, California",Baldwin Park city,75178,43368,31810
1600000US0603694,0603694,"Ballard CDP, California",Ballard CDP,764,572,192
1600000US0603708,0603708,"Ballico CDP, California",Ballico CDP,508,236,272
1600000US0603792,0603792,"Bangor CDP, California",Bangor CDP,407,388,19
1600000US0603820,0603820,"Banning city, California",Banning city,29978,18707,11271
1600000US0604030,0604030,"Barstow city, California",Barstow city,23248,9595,13653
1600000US0604198,0604198,"Bass Lake CDP, California",Bass Lake CDP,291,291,0
1600000US0604415,0604415,"Bay Point CDP, California",Bay Point CDP,25337,13903,11434
1600000US0604470,0604470,"Bayview CDP (Contra Costa County), California",Bayview CDP (Contra Costa County),2745,1858,887
1600000US0604478,0604478,"Bayview CDP (Humboldt County), California",Bayview CDP (Humboldt County),2770,1980,790
1600000US0604549,0604549,"Baywood Park CDP, California",Baywood Park CDP,1775,1697,78
1600000US0604576,0604576,"Beale AFB CDP, California",Beale AFB CDP,955,0,955
1600000US0604632,0604632,"Bear Creek CDP, California",Bear Creek CDP,95,69,26
1600000US0604716,0604716,"Bear Valley CDP (Alpine County), California",Bear Valley CDP (Alpine County),91,75,16
1600000US0604730,0604730,"Bear Valley CDP (Mariposa County), California",Bear Valley CDP (Mariposa County),135,135,0
1600000US0604734,0604734,"Bear Valley Springs CDP, California",Bear Valley Springs CDP,5286,4832,454
1600000US0604758,0604758,"Beaumont city, California",Beaumont city,48096,38081,10015
1600000US0604772,0604772,"Beckwourth CDP, California",Beckwourth CDP,388,388,0
1600000US0604856,0604856,"Belden CDP, California",Belden CDP,0,0,0
1600000US0604870,0604870,"Bell city, California",Bell city,34423,12644,21779
1600000US0604926,0604926,"Bella Vista CDP, California",Bella Vista CDP,3315,2792,523
1600000US0604938,0604938,"Bell Canyon CDP, California",Bell Canyon CDP,1991,1829,162
1600000US0604982,0604982,"Bellflower city, California",Bellflower city,75650,30555,45095
1600000US0604996,0604996,"Bell Gardens city, California",Bell Gardens city,41364,10299,31065
1600000US0605108,0605108,"Belmont city, California",Belmont city,26327,16604,9723
1600000US0605164,0605164,"Belvedere city, California",Belvedere city,2246,1782,464
1600000US0605262,0605262,"Benbow CDP, California",Benbow CDP,150,135,15
1600000US0605276,0605276,"Bend CDP, California",Bend CDP,425,425,0
1600000US0605290,0605290,"Benicia city, California",Benicia city,28134,20279,7855
1600000US0605332,0605332,"Ben Lomond CDP, California",Ben Lomond CDP,7272,4975,2297
1600000US0605346,0605346,"Benton CDP, California",Benton CDP,244,229,15
1600000US0605356,0605356,"Benton Park CDP, California",Benton Park CDP,5203,3210,1993
1600000US0606000,0606000,"Berkeley city, California",Berkeley city,109964,51131,58833
1600000US0606028,0606028,"Bermuda Dunes CDP, California",Bermuda Dunes CDP,6620,3860,2760
1600000US0606070,0606070,"Berry Creek CDP, California",Berry Creek CDP,1278,963,315
1600000US0606150,0606150,"Bertsch-Oceanview CDP, California",Bertsch-Oceanview CDP,2037,1611,426
1600000US0606210,0606210,"Bethel Island CDP, California",Bethel Island CDP,2015,1741,274
1600000US0606308,0606308,"Beverly Hills city, California",Beverly Hills city,33684,17007,16677
1600000US0606336,0606336,"Bieber CDP, California",Bieber CDP,145,105,40
1600000US0606406,0606406,"Big Bear City CDP, California",Big Bear City CDP,12600,7501,5099
1600000US0606434,0606434,"Big Bear Lake city, California",Big Bear Lake city,5276,2788,2488
1600000US0606475,0606475,"Big Bend CDP, California",Big Bend CDP,187,160,27
1600000US0606518,0606518,"Big Creek CDP, California",Big Creek CDP,159,39,120
1600000US0606560,0606560,"Biggs city, California",Biggs city,2648,2032,616
1600000US0606567,0606567,"Big Lagoon CDP, California",Big Lagoon CDP,92,78,14
1600000US0606616,0606616,"Big Pine CDP, California",Big Pine CDP,1373,1163,210
1600000US0606635,0606635,"Big River CDP, California",Big River CDP,1158,768,390
1600000US0606728,0606728,"Biola CDP, California",Biola CDP,1440,677,763
1600000US0606798,0606798,"Bishop city, California",Bishop city,3641,2000,1641
1600000US0606928,0606928,"Blackhawk CDP, California",Blackhawk CDP,10537,9689,848
1600000US0606935,0606935,"Blacklake CDP, California",Blacklake CDP,797,756,41
1600000US0606982,0606982,"Black Point-Green Point CDP, California",Black Point-Green Point CDP,1738,1497,241
1600000US0606994,0606994,"Blairsden CDP, California",Blairsden CDP,0,0,0
1600000US0607036,0607036,"Bloomfield CDP, California",Bloomfield CDP,243,183,60
1600000US0607064,0607064,"Bloomington CDP, California",Bloomington CDP,21696,14874,6822
1600000US0607162,0607162,"Blue Lake city, California",Blue Lake city,934,540,394
1600000US0607172,0607172,"Bluewater CDP, California",Bluewater CDP,142,142,0
1600000US0607218,0607218,"Blythe city, California",Blythe city,13076,7453,5623
1600000US0607246,0607246,"Bodega CDP, California",Bodega CDP,590,529,61
1600000US0607260,0607260,"Bodega Bay CDP, California",Bodega Bay CDP,1004,630,374
1600000US0607274,0607274,"Bodfish CDP, California",Bodfish CDP,2164,991,1173
1600000US0607316,0607316,"Bolinas CDP, California",Bolinas CDP,1205,875,330
1600000US0607372,0607372,"Bombay Beach CDP, California",Bombay Beach CDP,215,185,30
1600000US0607378,0607378,"Bonadelle Ranchos CDP, California",Bonadelle Ranchos CDP,5191,4664,527
1600000US0607414,0607414,"Bonita CDP, California",Bonita CDP,12345,10045,2300
1600000US0607470,0607470,"Bonny Doon CDP, California",Bonny Doon CDP,2808,2382,426
1600000US0607498,0607498,"Bonsall CDP, California",Bonsall CDP,4194,2758,1436
1600000US0607512,0607512,"Boonville CDP, California",Boonville CDP,992,512,480
1600000US0607525,0607525,"Bootjack CDP, California",Bootjack CDP,431,220,211
1600000US0607568,0607568,"Boron CDP, California",Boron CDP,2280,1149,1131
1600000US0607578,0607578,"Boronda CDP, California",Boronda CDP,1740,682,1058
1600000US0607596,0607596,"Borrego Springs CDP, California",Borrego Springs CDP,1864,1713,151
1600000US0607624,0607624,"Bostonia CDP, California",Bostonia CDP,17431,6593,10838
1600000US0607652,0607652,"Boulder Creek CDP, California",Boulder Creek CDP,5305,4461,844
1600000US0607694,0607694,"Boulevard CDP, California",Boulevard CDP,453,210,243
1600000US0607750,0607750,"Bowles CDP, California",Bowles CDP,234,99,135
1600000US0607848,0607848,"Boyes Hot Springs CDP, California",Boyes Hot Springs CDP,7973,3096,4877
1600000US0607946,0607946,"Bradbury city, California",Bradbury city,825,726,99
1600000US0607974,0607974,"Bradley CDP, California",Bradley CDP,99,75,24
1600000US0608058,0608058,"Brawley city, California",Brawley city,25826,13436,12390
1600000US0608100,0608100,"Brea city, California",Brea city,44067,28228,15839
1600000US0608142,0608142,"Brentwood city, California",Brentwood city,62801,49031,13770
1600000US0608172,0608172,"Bret Harte CDP, California",Bret Harte CDP,5020,2341,2679
1600000US0608240,0608240,"Bridgeport CDP, California",Bridgeport CDP,473,455,18
1600000US0608310,0608310,"Brisbane city, California",Brisbane city,4633,3760,873
1600000US0608338,0608338,"Broadmoor CDP, California",Broadmoor CDP,4102,3311,791
1600000US0608478,0608478,"Brookdale CDP, California",Brookdale CDP,1293,1082,211
1600000US0608506,0608506,"Brooks CDP, California",Brooks CDP,41,0,41
1600000US0608530,0608530,"Brooktrails CDP, California",Brooktrails CDP,4559,3323,1236
1600000US0608680,0608680,"Buckhorn CDP, California",Buckhorn CDP,2175,1762,413
1600000US0608716,0608716,"Buck Meadows CDP, California",Buck Meadows CDP,0,0,0
1600000US0608744,0608744,"Bucks Lake CDP, California",Bucks Lake CDP,21,21,0
1600000US0608758,0608758,"Buellton city, California",Buellton city,5276,3169,2107
1600000US0608786,0608786,"Buena Park city, California",Buena Park city,81372,46942,34430
1600000US0608828,0608828,"Buena Vista CDP, California",Buena Vista CDP,573,415,158
1600000US0608954,0608954,"Burbank city, California",Burbank city,102887,49724,53163
1600000US0608968,0608968,"Burbank CDP, California",Burbank CDP,5377,3185,2192
1600000US0609066,0609066,"Burlingame city, California",Burlingame city,29581,17001,12580
1600000US0609122,0609122,"Burney CDP, California",Burney CDP,3654,2421,1233
1600000US0609150,0609150,"Burnt Ranch CDP, California",Burnt Ranch CDP,185,177,8
1600000US0609310,0609310,"Butte Creek Canyon CDP, California",Butte Creek Canyon CDP,677,613,64
1600000US0609318,0609318,"Butte Meadows CDP, California",Butte Meadows CDP,25,25,0
1600000US0609324,0609324,"Butte Valley CDP, California",Butte Valley CDP,899,817,82
1600000US0609332,0609332,"Buttonwillow CDP, California",Buttonwillow CDP,1331,550,781
1600000US0609346,0609346,"Byron CDP, California",Byron CDP,1968,1346,622
1600000US0609353,0609353,"Bystrom CDP, California",Bystrom CDP,3714,1834,1880
1600000US0609360,0609360,"Cabazon CDP, California",Cabazon CDP,2254,1497,757
1600000US0609598,0609598,"Calabasas city, California",Calabasas city,23834,16108,7726
1600000US0609710,0609710,"Calexico city, California",Calexico city,39758,23528,16230
1600000US0609780,0609780,"California City city, California",California City city,11691,6587,5104
1600000US0609822,0609822,"California Hot Springs CDP, California",California Hot Springs CDP,40,40,0
1600000US0609834,0609834,"California Pines CDP, California",California Pines CDP,367,247,120
1600000US0609835,0609835,"California Polytechnic State University CDP, California",California Polytechnic State University CDP,161,138,23
1600000US0609864,0609864,"Calimesa city, California",Calimesa city,9103,7607,1496
1600000US0609878,0609878,"Calipatria city, California",Calipatria city,3063,1555,1508
1600000US0609892,0609892,"Calistoga city, California",Calistoga city,5273,3408,1865
1600000US0609948,0609948,"Callender CDP, California",Callender CDP,1638,921,717
1600000US0609990,0609990,"Calpella CDP, California",Calpella CDP,620,545,75
1600000US0610004,0610004,"Calpine CDP, California",Calpine CDP,164,128,36
1600000US0610032,0610032,"Calwa CDP, California",Calwa CDP,2363,868,1495
1600000US0610042,0610042,"Camanche North Shore CDP, California",Camanche North Shore CDP,1188,1010,178
1600000US0610044,0610044,"Camanche Village CDP, California",Camanche Village CDP,1344,1322,22
1600000US0610046,0610046,"Camarillo city, California",Camarillo city,67484,43083,24401
1600000US0610074,0610074,"Cambria CDP, California",Cambria CDP,5550,4083,1467
1600000US0610088,0610088,"Cambrian Park CDP, California",Cambrian Park CDP,2968,2307,661
1600000US0610256,0610256,"Cameron Park CDP, California",Cameron Park CDP,18362,12088,6274
1600000US0610270,0610270,"Camino CDP, California",Camino CDP,2065,1465,600
1600000US0610301,0610301,"Camino Tassajara CDP, California",Camino Tassajara CDP,5870,5092,778
1600000US0610345,0610345,"Campbell city, California",Campbell city,42572,21555,21017
1600000US0610494,0610494,"Camp Nelson CDP, California",Camp Nelson CDP,0,0,0
1600000US0610508,0610508,"Campo CDP, California",Campo CDP,3183,2299,884
1600000US0610554,0610554,"Camp Pendleton Mainside CDP, California",Camp Pendleton Mainside CDP,3866,0,3866
1600000US0610561,0610561,"Camp Pendleton South CDP, California",Camp Pendleton South CDP,14999,0,14999
1600000US0610676,0610676,"Camptonville CDP, California",Camptonville CDP,175,140,35
1600000US0610732,0610732,"Canby CDP, California",Canby CDP,33,0,33
1600000US0610816,0610816,"Cantua Creek CDP, California",Cantua Creek CDP,368,96,272
1600000US0610914,0610914,"Canyondam CDP, California",Canyondam CDP,0,0,0
1600000US0610928,0610928,"Canyon Lake city, California",Canyon Lake city,11225,8496,2729
1600000US0611040,0611040,"Capitola city, California",Capitola city,9896,4577,5319
1600000US0611166,0611166,"Caribou CDP, California",Caribou CDP,0,0,0
1600000US0611194,0611194,"Carlsbad city, California",Carlsbad city,113886,72348,41538
1600000US0611250,0611250,"Carmel-by-the-Sea city, California",Carmel-by-the-Sea city,3761,1871,1890
1600000US0611324,0611324,"Carmel Valley Village CDP, California",Carmel Valley Village CDP,4149,3127,1022
1600000US0611376,0611376,"Carmet CDP, California",Carmet CDP,0,0,0
1600000US0611390,0611390,"Carmichael CDP, California",Carmichael CDP,73994,40791,33203
1600000US0611418,0611418,"Carnelian Bay CDP, California",Carnelian Bay CDP,565,460,105
1600000US0611446,0611446,"Carpinteria city, California",Carpinteria city,13416,7397,6019
1600000US0611481,0611481,"Carrick CDP, California",Carrick CDP,58,58,0
1600000US0611530,0611530,"Carson city, California",Carson city,90530,67359,23171
1600000US0611600,0611600,"Cartago CDP, California",Cartago CDP,49,5,44
1600000US0611614,0611614,"Caruthers CDP, California",Caruthers CDP,2245,1694,551
1600000US0611656,0611656,"Casa Conejo CDP, California",Casa Conejo CDP,3173,2498,675
1600000US0611691,0611691,"Casa de Oro-Mount Helix CDP, California",Casa de Oro-Mount Helix CDP,19111,14534,4577
1600000US0611696,0611696,"Casa Loma CDP, California",Casa Loma CDP,1301,737,564
1600000US0611754,0611754,"Casmalia CDP, California",Casmalia CDP,88,68,20
1600000US0611768,0611768,"Caspar CDP, California",Caspar CDP,302,200,102
1600000US0611782,0611782,"Cassel CDP, California",Cassel CDP,266,144,122
1600000US0611796,0611796,"Castaic CDP, California",Castaic CDP,18479,15747,2732
1600000US0611824,0611824,"Castella CDP, California",Castella CDP,230,165,65
1600000US0611915,0611915,"Castle Hill CDP, California",Castle Hill CDP,1159,1145,14
1600000US0611964,0611964,"Castro Valley CDP, California",Castro Valley CDP,63174,44506,18668
1600000US0611978,0611978,"Castroville CDP, California",Castroville CDP,6315,2294,4021
1600000US0612048,0612048,"Cathedral City city, California",Cathedral City city,54438,32481,21957
1600000US0612062,0612062,"Catheys Valley CDP, California",Catheys Valley CDP,741,675,66
1600000US0612132,0612132,"Cayucos CDP, California",Cayucos CDP,2228,1282,946
1600000US0612146,0612146,"Cazadero CDP, California",Cazadero CDP,320,264,56
1600000US0612216,0612216,"Cedar Flat CDP, California",Cedar Flat CDP,886,707,179
1600000US0612300,0612300,"Cedar Ridge CDP, California",Cedar Ridge CDP,1267,1013,254
1600000US0612314,0612314,"Cedar Slope CDP, California",Cedar Slope CDP,0,0,0
1600000US0612328,0612328,"Cedarville CDP, California",Cedarville CDP,695,439,256
1600000US0612412,0612412,"Centerville CDP (Fresno County), California",Centerville CDP (Fresno County),314,149,165
1600000US0612415,0612415,"Centerville CDP (Shasta County), California",Centerville CDP (Shasta County),2166,1952,214
1600000US0612524,0612524,"Ceres city, California",Ceres city,47646,28638,19008
1600000US0612552,0612552,"Cerritos city, California",Cerritos city,49233,36701,12532
1600000US0612594,0612594,"Chalfant CDP, California",Chalfant CDP,1010,933,77
1600000US0612612,0612612,"Challenge-Brownsville CDP, California",Challenge-Brownsville CDP,1163,1014,149
1600000US0612669,0612669,"Channel Islands Beach CDP, California",Channel Islands Beach CDP,2699,1307,1392
1600000US0612730,0612730,"Charleston View CDP, California",Charleston View CDP,6,6,0
1600000US0612734,0612734,"Charter Oak CDP, California",Charter Oak CDP,9897,6028,3869
1600000US0612818,0612818,"Cherokee CDP, California",Cherokee CDP,100,90,10
1600000US0612860,0612860,"Cherokee Strip CDP, California",Cherokee Strip CDP,289,78,211
1600000US0612902,0612902,"Cherryland CDP, California",Cherryland CDP,15430,4293,11137
1600000US0612916,0612916,"Cherry Valley CDP, California",Cherry Valley CDP,7868,6550,1318
1600000US0612930,0612930,"Chester CDP, California",Chester CDP,2050,1625,425
1600000US0613014,0613014,"Chico city, California",Chico city,95016,45238,49778
1600000US0613077,0613077,"Chilcoot-Vinton CDP, California",Chilcoot-Vinton CDP,340,340,0
1600000US0613157,0613157,"China Lake Acres CDP, California",China Lake Acres CDP,2450,1084,1366
1600000US0613182,0613182,"Chinese Camp CDP, California",Chinese Camp CDP,146,130,16
1600000US0613210,0613210,"Chino city, California",Chino city,76753,47583,29170
1600000US0613214,0613214,"Chino Hills city, California",Chino Hills city,82675,61180,21495
1600000US0613278,0613278,"Choctaw Valley CDP, California",Choctaw Valley CDP,252,185,67
1600000US0613294,0613294,"Chowchilla city, California",Chowchilla city,11358,5896,5462
1600000US0613364,0613364,"Chualar CDP, California",Chualar CDP,1413,734,679
1600000US0613392,0613392,"Chula Vista city, California",Chula Vista city,266776,165103,101673
1600000US0613560,0613560,"Citrus CDP, California",Citrus CDP,10080,6830,3250
1600000US0613588,0613588,"Citrus Heights city, California",Citrus Heights city,86987,51149,35838
1600000US0613756,0613756,"Claremont city, California",Claremont city,31352,22212,9140
1600000US0613784,0613784,"Clarksburg CDP, California",Clarksburg CDP,366,272,94
1600000US0613854,0613854,"Clay CDP, California",Clay CDP,1130,980,150
1600000US0613882,0613882,"Clayton city, California",Clayton city,11557,10299,1258
1600000US0613910,0613910,"Clear Creek CDP, California",Clear Creek CDP,293,173,120
1600000US0613945,0613945,"Clearlake city, California",Clearlake city,15155,8365,6790
1600000US0613966,0613966,"Clearlake Oaks CDP, California",Clearlake Oaks CDP,2194,1393,801
1600000US0613985,0613985,"Clearlake Riviera CDP, California",Clearlake Riviera CDP,4408,3298,1110
1600000US0614008,0614008,"Cleone CDP, California",Cleone CDP,841,817,24
1600000US0614106,0614106,"Clio CDP, California",Clio CDP,184,111,73
1600000US0614148,0614148,"Clipper Mills CDP, California",Clipper Mills CDP,451,153,298
1600000US0614190,0614190,"Cloverdale city, California",Cloverdale city,8786,5974,2812
1600000US0614218,0614218,"Clovis city, California",Clovis city,112151,74983,37168
1600000US0614232,0614232,"Clyde CDP, California",Clyde CDP,737,624,113
1600000US0614260,0614260,"Coachella city, California",Coachella city,45658,33482,12176
1600000US0614274,0614274,"Coalinga city, California",Coalinga city,13655,8676,4979
1600000US0614288,0614288,"Coarsegold CDP, California",Coarsegold CDP,4869,4460,409
1600000US0614302,0614302,"Cobb CDP, California",Cobb CDP,805,644,161
1600000US0614406,0614406,"Coffee Creek CDP, California",Coffee Creek CDP,177,153,24
1600000US0614442,0614442,"Cohasset CDP, California",Cohasset CDP,497,436,61
1600000US0614450,0614450,"Cold Springs CDP (El Dorado County), California",Cold Springs CDP (El Dorado County),675,493,182
1600000US0614454,0614454,"Cold Springs CDP (Tuolumne County), California",Cold Springs CDP (Tuolumne County),0,0,0
1600000US0614484,0614484,"Coleville CDP, California",Coleville CDP,353,28,325
1600000US0614498,0614498,"Colfax city, California",Colfax city,2258,1225,1033
1600000US0614554,0614554,"College City CDP, California",College City CDP,205,158,47
1600000US0614708,0614708,"Collierville CDP, California",Collierville CDP,2341,1717,624
1600000US0614736,0614736,"Colma town, California",Colma town,1492,728,764
1600000US0614764,0614764,"Coloma CDP, California",Coloma CDP,376,198,178
1600000US0614890,0614890,"Colton city, California",Colton city,53892,29029,24863
1600000US0614904,0614904,"Columbia CDP, California",Columbia CDP,1947,1405,542
1600000US0614946,0614946,"Colusa city, California",Colusa city,6046,3678,2368
1600000US0614974,0614974,"Commerce city, California",Commerce city,12649,7505,5144
1600000US0615030,0615030,"Comptche CDP, California",Comptche CDP,142,59,83
1600000US0615044,0615044,"Compton city, California",Compton city,95189,53653,41536
1600000US0616000,0616000,"Concord city, California",Concord city,127989,75747,52242
1600000US0616035,0616035,"Concow CDP, California",Concow CDP,472,340,132
1600000US0616090,0616090,"Contra Costa Centre CDP, California",Contra Costa Centre CDP,6662,1463,5199
1600000US0616210,0616210,"Copperopolis CDP, California",Copperopolis CDP,3566,3082,484
1600000US0616224,0616224,"Corcoran city, California",Corcoran city,13135,5794,7341
1600000US0616322,0616322,"Corning city, California",Corning city,7569,4628,2941
1600000US0616350,0616350,"Corona city, California",Corona city,167392,108912,58480
1600000US0616378,0616378,"Coronado city, California",Coronado city,20895,10347,10548
1600000US0616420,0616420,"Coronita CDP, California",Coronita CDP,3945,3557,388
1600000US0616434,0616434,"Corralitos CDP, California",Corralitos CDP,2232,2057,175
1600000US0616462,0616462,"Corte Madera town, California",Corte Madera town,9793,6774,3019
1600000US0616532,0616532,"Costa Mesa city, California",Costa Mesa city,111036,46473,64563
1600000US0616560,0616560,"Cotati city, California",Cotati city,7469,4319,3150
1600000US0616580,0616580,"Coto de Caza CDP, California",Coto de Caza CDP,15509,14173,1336
1600000US0616623,0616623,"Cottonwood CDP (Kern County), California",Cottonwood CDP (Kern County),3121,692,2429
1600000US0616630,0616630,"Cottonwood CDP (Shasta County), California",Cottonwood CDP (Shasta County),5435,4430,1005
1600000US0616644,0616644,"Coulterville CDP, California",Coulterville CDP,23,0,23
1600000US0616651,0616651,"Country Club CDP, California",Country Club CDP,9227,5940,3287
1600000US0616714,0616714,"Courtland CDP, California",Courtland CDP,473,306,167
1600000US0616728,0616728,"Covelo CDP, California",Covelo CDP,1343,951,392
1600000US0616742,0616742,"Covina city, California",Covina city,47351,27850,19501
1600000US0616762,0616762,"Cowan CDP, California",Cowan CDP,472,202,270
1600000US0616886,0616886,"Crane Creek CDP, California",Crane Creek CDP,52,52,0
1600000US0617022,0617022,"Crescent City city, California",Crescent City city,4074,1541,2533
1600000US0617050,0617050,"Crescent Mills CDP, California",Crescent Mills CDP,70,51,19
1600000US0617078,0617078,"Cressey CDP, California",Cressey CDP,243,126,117
1600000US0617106,0617106,"Crest CDP, California",Crest CDP,2721,2474,247
1600000US0617162,0617162,"Crestline CDP, California",Crestline CDP,9292,6078,3214
1600000US0617232,0617232,"Creston CDP, California",Creston CDP,31,31,0
1600000US0617267,0617267,"C-Road CDP, California",C-Road CDP,90,45,45
1600000US0617274,0617274,"Crockett CDP, California",Crockett CDP,3205,1993,1212
1600000US0617288,0617288,"Cromberg CDP, California",Cromberg CDP,312,296,16
1600000US0617372,0617372,"Crowley Lake CDP, California",Crowley Lake CDP,1145,1015,130
1600000US0617428,0617428,"Crows Landing CDP, California",Crows Landing CDP,346,167,179
1600000US0617498,0617498,"Cudahy city, California",Cudahy city,23590,3621,19969
1600000US0617568,0617568,"Culver City city, California",Culver City city,38578,22211,16367
1600000US0617610,0617610,"Cupertino city, California",Cupertino city,59379,36002,23377
1600000US0617708,0617708,"Cutler CDP, California",Cutler CDP,5296,2164,3132
1600000US0617722,0617722,"Cutten CDP, California",Cutten CDP,3304,2338,966
1600000US0617727,0617727,"Cuyama CDP, California",Cuyama CDP,11,11,0
1600000US0617750,0617750,"Cypress city, California",Cypress city,48996,33935,15061
1600000US0617876,0617876,"Dales CDP, California",Dales CDP,0,0,0
1600000US0617918,0617918,"Daly City city, California",Daly City city,106371,65602,40769
1600000US0617946,0617946,"Dana Point city, California",Dana Point city,33646,20535,13111
1600000US0617988,0617988,"Danville town, California",Danville town,44809,38654,6155
1600000US0617995,0617995,"Daphnedale Park CDP, California",Daphnedale Park CDP,145,106,39
1600000US0618030,0618030,"Darwin CDP, California",Darwin CDP,90,90,0
1600000US0618086,0618086,"Davenport CDP, California",Davenport CDP,509,303,206
1600000US0618100,0618100,"Davis city, California",Davis city,66851,28954,37897
1600000US0618153,0618153,"Day Valley CDP, California",Day Valley CDP,3384,3128,256
1600000US0618324,0618324,"Deer Park CDP, California",Deer Park CDP,752,509,243
1600000US0618352,0618352,"Del Aire CDP, California",Del Aire CDP,10395,7679,2716
1600000US0618394,0618394,"Delano city, California",Delano city,44263,26714,17549
1600000US0618422,0618422,"Del Dios CDP, California",Del Dios CDP,302,239,63
1600000US0618450,0618450,"Delft Colony CDP, California",Delft Colony CDP,1512,823,689
1600000US0618464,0618464,"Delhi CDP, California",Delhi CDP,11825,8064,3761
1600000US0618485,0618485,"Delleker CDP, California",Delleker CDP,601,422,179
1600000US0618506,0618506,"Del Mar city, California",Del Mar city,4331,2514,1817
1600000US0618590,0618590,"Del Monte Forest CDP, California",Del Monte Forest CDP,3577,2946,631
1600000US0618674,0618674,"Del Rey CDP, California",Del Rey CDP,1246,555,691
1600000US0618688,0618688,"Del Rey Oaks city, California",Del Rey Oaks city,1518,1076,442
1600000US0618695,0618695,"Del Rio CDP, California",Del Rio CDP,1241,828,413
1600000US0618856,0618856,"Denair CDP, California",Denair CDP,5702,4082,1620
1600000US0618926,0618926,"Derby Acres CDP, California",Derby Acres CDP,288,198,90
1600000US0618940,0618940,"Descanso CDP, California",Descanso CDP,1398,1296,102
1600000US0618982,0618982,"Desert Center CDP, California",Desert Center CDP,272,222,50
1600000US0618986,0618986,"Desert Edge CDP, California",Desert Edge CDP,3480,3110,370
1600000US0618996,0618996,"Desert Hot Springs city, California",Desert Hot Springs city,29123,14464,14659
1600000US0619022,0619022,"Desert Palms CDP, California",Desert Palms CDP,6599,5531,1068
1600000US0619024,0619024,"Desert Shores CDP, California",Desert Shores CDP,411,262,149
1600000US0619052,0619052,"Desert View Highlands CDP, California",Desert View Highlands CDP,3259,1655,1604
1600000US0619150,0619150,"Diablo CDP, California",Diablo CDP,834,834,0
1600000US0619155,0619155,"Diablo Grande CDP, California",Diablo Grande CDP,892,842,50
1600000US0619192,0619192,"Diamond Bar city, California",Diamond Bar city,55670,41775,13895
1600000US0619220,0619220,"Diamond Springs CDP, California",Diamond Springs CDP,11195,8122,3073
1600000US0619248,0619248,"Di Giorgio CDP, California",Di Giorgio CDP,398,99,299
1600000US0619262,0619262,"Dillon Beach CDP, California",Dillon Beach CDP,309,174,135
1600000US0619318,0619318,"Dinuba city, California",Dinuba city,24246,12369,11877
1600000US0619339,0619339,"Discovery Bay CDP, California",Discovery Bay CDP,15853,12974,2879
1600000US0619402,0619402,"Dixon city, California",Dixon city,20083,11883,8200
1600000US0619406,0619406,"Dixon Lane-MeadowCreek CDP, California",Dixon Lane-MeadowCreek CDP,2755,2557,198
1600000US0619416,0619416,"Dobbins CDP, California",Dobbins CDP,130,130,0
1600000US0619440,0619440,"Dogtown CDP, California",Dogtown CDP,3006,2352,654
1600000US0619455,0619455,"Dollar Point CDP, California",Dollar Point CDP,909,601,308
1600000US0619570,0619570,"Dorrington CDP, California",Dorrington CDP,404,385,19
1600000US0619584,0619584,"Dorris city, California",Dorris city,867,604,263
1600000US0619612,0619612,"Dos Palos city, California",Dos Palos city,5239,3238,2001
1600000US0619654,0619654,"Dos Palos Y CDP, California",Dos Palos Y CDP,206,71,135
1600000US0619724,0619724,"Douglas City CDP, California",Douglas City CDP,678,480,198
1600000US0619766,0619766,"Downey city, California",Downey city,110575,56924,53651
1600000US0619794,0619794,"Downieville CDP, California",Downieville CDP,99,89,10
1600000US0619878,0619878,"Doyle CDP, California",Doyle CDP,745,684,61
1600000US0619976,0619976,"Drytown CDP, California",Drytown CDP,13,13,0
1600000US0619990,0619990,"Duarte city, California",Duarte city,21073,14175,6898
1600000US0620018,0620018,"Dublin city, California",Dublin city,62487,41886,20601
1600000US0620032,0620032,"Ducor CDP, California",Ducor CDP,708,658,50
1600000US0620228,0620228,"Dunnigan CDP, California",Dunnigan CDP,1391,915,476
1600000US0620242,0620242,"Dunsmuir city, California",Dunsmuir city,1870,1038,832
1600000US0620270,0620270,"Durham CDP, California",Durham CDP,6213,4013,2200
1600000US0620284,0620284,"Dustin Acres CDP, California",Dustin Acres CDP,568,421,147
1600000US0620298,0620298,"Dutch Flat CDP, California",Dutch Flat CDP,133,96,37
1600000US0620424,0620424,"Eagleville CDP, California",Eagleville CDP,15,15,0
1600000US0620438,0620438,"Earlimart CDP, California",Earlimart CDP,8908,5817,3091
1600000US0620515,0620515,"East Bakersfield CDP, California",East Bakersfield CDP,10065,2260,7805
1600000US0620574,0620574,"Eastern Goleta Valley CDP, California",Eastern Goleta Valley CDP,28623,21035,7588
1600000US0620598,0620598,"East Foothills CDP, California",East Foothills CDP,6745,5800,945
1600000US0620697,0620697,"East Hemet CDP, California",East Hemet CDP,20021,11206,8815
1600000US0620802,0620802,"East Los Angeles CDP, California",East Los Angeles CDP,120296,44238,76058
1600000US0620900,0620900,"East Nicolaus CDP, California",East Nicolaus CDP,172,92,80
1600000US0620903,0620903,"East Niles CDP, California",East Niles CDP,29703,17870,11833
1600000US0620907,0620907,"East Oakdale CDP, California",East Oakdale CDP,2370,2309,61
1600000US0620928,0620928,"Easton CDP, California",Easton CDP,2224,1380,844
1600000US0620942,0620942,"East Orosi CDP, California",East Orosi CDP,624,210,414
1600000US0620956,0620956,"East Palo Alto city, California",East Palo Alto city,29271,14209,15062
1600000US0620984,0620984,"East Pasadena CDP, California",East Pasadena CDP,6003,4151,1852
1600000US0621012,0621012,"East Porterville CDP, California",East Porterville CDP,5383,3099,2284
1600000US0621026,0621026,"East Quincy CDP, California",East Quincy CDP,2232,1310,922
1600000US0621034,0621034,"East Rancho Dominguez CDP, California",East Rancho Dominguez CDP,15171,8990,6181
1600000US0621061,0621061,"East Richmond Heights CDP, California",East Richmond Heights CDP,3468,2684,784
1600000US0621096,0621096,"East San Gabriel CDP, California",East San Gabriel CDP,22952,13869,9083
1600000US0621138,0621138,"East Shore CDP, California",East Shore CDP,139,139,0
1600000US0621188,0621188,"East Sonora CDP, California",East Sonora CDP,2486,1845,641
1600000US0621210,0621210,"East Tulare Villa CDP, California",East Tulare Villa CDP,849,452,397
1600000US0621230,0621230,"Eastvale city, California",Eastvale city,65748,51641,14107
1600000US0621292,0621292,"East Whittier CDP, California",East Whittier CDP,10161,6583,3578
1600000US0621530,0621530,"Edgewood CDP, California",Edgewood CDP,39,20,19
1600000US0621544,0621544,"Edison CDP, California",Edison CDP,109,64,45
1600000US0621558,0621558,"Edmundson Acres CDP, California",Edmundson Acres CDP,341,242,99
1600000US0621565,0621565,"Edna CDP, California",Edna CDP,408,343,65
1600000US0621600,0621600,"Edwards AFB CDP, California",Edwards AFB CDP,2512,0,2512
1600000US0621691,0621691,"El Adobe CDP, California",El Adobe CDP,118,85,33
1600000US0621712,0621712,"El Cajon city, California",El Cajon city,100850,41033,59817
1600000US0621782,0621782,"El Centro city, California",El Centro city,43436,23041,20395
1600000US0621788,0621788,"El Centro Naval Air Facility CDP, California",El Centro Naval Air Facility CDP,244,0,244
1600000US0621796,0621796,"El Cerrito city, California",El Cerrito city,25151,14218,10933
1600000US0621810,0621810,"El Cerrito CDP, California",El Cerrito CDP,5251,4089,1162
1600000US0621880,0621880,"El Dorado Hills CDP, California",El Dorado Hills CDP,47091,40799,6292
1600000US0621894,0621894,"Eldridge CDP, California",Eldridge CDP,954,499,455
1600000US0621916,0621916,"Elfin Forest CDP, California",Elfin Forest CDP,455,455,0
1600000US0621936,0621936,"El Granada CDP, California",El Granada CDP,6048,5348,700
1600000US0621964,0621964,"Elizabeth Lake CDP, California",Elizabeth Lake CDP,1632,1301,331
1600000US0622006,0622006,"Elk Creek CDP, California",Elk Creek CDP,175,45,130
1600000US0622020,0622020,"Elk Grove city, California",Elk Grove city,172518,127692,44826
1600000US0622034,0622034,"Elkhorn CDP, California",Elkhorn CDP,998,784,214
1600000US0622104,0622104,"El Macero CDP, California",El Macero CDP,1086,1046,40
1600000US0622146,0622146,"Elmira CDP, California",Elmira CDP,234,36,198
1600000US0622230,0622230,"El Monte city, California",El Monte city,112590,47082,65508
1600000US0622235,0622235,"El Monte Mobile Village CDP, California",El Monte Mobile Village CDP,0,0,0
1600000US0622286,0622286,"El Nido CDP, California",El Nido CDP,283,93,190
1600000US0622300,0622300,"El Paso de Robles (Paso Robles) city, California",El Paso de Robles (Paso Robles) city,31363,18686,12677
1600000US0622328,0622328,"El Portal CDP, California",El Portal CDP,271,116,155
1600000US0622360,0622360,"El Rancho CDP, California",El Rancho CDP,0,0,0
1600000US0622370,0622370,"El Rio CDP, California",El Rio CDP,6496,3179,3317
1600000US0622412,0622412,"El Segundo city, California",El Segundo city,16540,8114,8426
1600000US0622454,0622454,"El Sobrante CDP (Contra Costa County), California",El Sobrante CDP (Contra Costa County),14727,9709,5018
1600000US0622457,0622457,"El Sobrante CDP (Riverside County), California",El Sobrante CDP (Riverside County),13063,11980,1083
1600000US0622510,0622510,"El Verano CDP, California",El Verano CDP,3236,1845,1391
1600000US0622524,0622524,"Elverta CDP, California",Elverta CDP,5227,4229,998
1600000US0622587,0622587,"Emerald Lake Hills CDP, California",Emerald Lake Hills CDP,4842,4498,344
1600000US0622594,0622594,"Emeryville city, California",Emeryville city,11674,3228,8446
1600000US0622622,0622622,"Empire CDP, California",Empire CDP,3150,1731,1419
1600000US0622678,0622678,"Encinitas city, California",Encinitas city,62620,41458,21162
1600000US0622790,0622790,"Escalon city, California",Escalon city,7531,4921,2610
1600000US0622804,0622804,"Escondido city, California",Escondido city,148041,77141,70900
1600000US0622846,0622846,"Esparto CDP, California",Esparto CDP,4009,2829,1180
1600000US0622972,0622972,"Etna city, California",Etna city,740,441,299
1600000US0623000,0623000,"Eucalyptus Hills CDP, California",Eucalyptus Hills CDP,6435,5351,1084
1600000US0623042,0623042,"Eureka city, California",Eureka city,25704,12071,13633
1600000US0623126,0623126,"Exeter city, California",Exeter city,10355,6085,4270
1600000US0623150,0623150,"Fairbanks Ranch CDP, California",Fairbanks Ranch CDP,2929,2208,721
1600000US0623158,0623158,"Fairfax CDP, California",Fairfax CDP,1778,1439,339
1600000US0623168,0623168,"Fairfax town, California",Fairfax town,7595,4855,2740
1600000US0623182,0623182,"Fairfield city, California",Fairfield city,114798,68782,46016
1600000US0623196,0623196,"Fairhaven CDP, California",Fairhaven CDP,240,139,101
1600000US0623210,0623210,"Fairmead CDP, California",Fairmead CDP,1133,989,144
1600000US0623294,0623294,"Fair Oaks CDP, California",Fair Oaks CDP,30246,21610,8636
1600000US0623350,0623350,"Fairview CDP, California",Fairview CDP,10649,9047,1602
1600000US0623462,0623462,"Fallbrook CDP, California",Fallbrook CDP,32178,18957,13221
1600000US0623532,0623532,"Fall River Mills CDP, California",Fall River Mills CDP,345,122,223
1600000US0623616,0623616,"Farmersville city, California",Farmersville city,10842,7499,3343
1600000US0623630,0623630,"Farmington CDP, California",Farmington CDP,169,59,110
1600000US0623812,0623812,"Fellows CDP, California",Fellows CDP,54,48,6
1600000US0623826,0623826,"Felton CDP, California",Felton CDP,3197,2533,664
1600000US0623910,0623910,"Ferndale city, California",Ferndale city,1387,809,578
1600000US0623973,0623973,"Fetters Hot Springs-Agua Caliente CDP, California",Fetters Hot Springs-Agua Caliente CDP,3528,1952,1576
1600000US0623980,0623980,"Fiddletown CDP, California",Fiddletown CDP,211,143,68
1600000US0624008,0624008,"Fieldbrook CDP, California",Fieldbrook CDP,793,707,86
1600000US0624022,0624022,"Fields Landing CDP, California",Fields Landing CDP,577,130,447
1600000US0624092,0624092,"Fillmore city, California",Fillmore city,15437,10060,5377
1600000US0624134,0624134,"Firebaugh city, California",Firebaugh city,7746,3483,4263
1600000US0624218,0624218,"Fish Camp CDP, California",Fish Camp CDP,50,50,0
1600000US0624477,0624477,"Florence-Graham CDP, California",Florence-Graham CDP,64709,25496,39213
1600000US0624498,0624498,"Florin CDP, California",Florin CDP,48365,26022,22343
1600000US0624526,0624526,"Floriston CDP, California",Floriston CDP,28,28,0
1600000US0624568,0624568,"Flournoy CDP, California",Flournoy CDP,161,142,19
1600000US0624638,0624638,"Folsom city, California",Folsom city,74555,53882,20673
1600000US0624680,0624680,"Fontana city, California",Fontana city,212148,141795,70353
1600000US0624722,0624722,"Foothill Farms CDP, California",Foothill Farms CDP,35634,17160,18474
1600000US0624750,0624750,"Forbestown CDP, California",Forbestown CDP,369,326,43
1600000US0624764,0624764,"Ford City CDP, California",Ford City CDP,4909,1936,2973
1600000US0624834,0624834,"Foresthill CDP, California",Foresthill CDP,1545,1095,450
1600000US0624897,0624897,"Forest Meadows CDP, California",Forest Meadows CDP,1324,1059,265
1600000US0624918,0624918,"Forest Ranch CDP, California",Forest Ranch CDP,1551,1551,0
1600000US0624960,0624960,"Forestville CDP, California",Forestville CDP,3741,2779,962
1600000US0625030,0625030,"Fort Bidwell CDP, California",Fort Bidwell CDP,174,70,104
1600000US0625058,0625058,"Fort Bragg city, California",Fort Bragg city,7092,2545,4547
1600000US0625086,0625086,"Fort Dick CDP, California",Fort Dick CDP,1405,1272,133
1600000US0625093,0625093,"Fort Hunter Liggett CDP, California",Fort Hunter Liggett CDP,95,0,95
1600000US0625114,0625114,"Fort Irwin CDP, California",Fort Irwin CDP,7920,20,7900
1600000US0625128,0625128,"Fort Jones city, California",Fort Jones city,578,298,280
1600000US0625296,0625296,"Fortuna city, California",Fortuna city,11992,6829,5163
1600000US0625300,0625300,"Fort Washington CDP, California",Fort Washington CDP,215,215,0
1600000US0625338,0625338,"Foster City city, California",Foster City city,32879,17618,15261
1600000US0625380,0625380,"Fountain Valley city, California",Fountain Valley city,55609,37659,17950
1600000US0625436,0625436,"Fowler city, California",Fowler city,6318,3451,2867
1600000US0625488,0625488,"Franklin CDP (Merced County), California",Franklin CDP (Merced County),7709,5075,2634
1600000US0625506,0625506,"Franklin CDP (Sacramento County), California",Franklin CDP (Sacramento County),26,16,10
1600000US0625534,0625534,"Frazier Park CDP, California",Frazier Park CDP,3121,2159,962
1600000US0625576,0625576,"Freedom CDP, California",Freedom CDP,3959,2526,1433
1600000US0625590,0625590,"Freeport CDP, California",Freeport CDP,70,0,70
1600000US0626000,0626000,"Fremont city, California",Fremont city,233351,143718,89633
1600000US0626028,0626028,"French Camp CDP, California",French Camp CDP,1223,524,699
1600000US0626056,0626056,"French Gulch CDP, California",French Gulch CDP,441,357,84
1600000US0626067,0626067,"French Valley CDP, California",French Valley CDP,37818,29740,8078
1600000US0627000,0627000,"Fresno city, California",Fresno city,516558,247700,268858
1600000US0627014,0627014,"Friant CDP, California",Friant CDP,541,313,228
1600000US0627080,0627080,"Fruitdale CDP, California",Fruitdale CDP,1114,897,217
1600000US0627130,0627130,"Fruitridge Pocket CDP, California",Fruitridge Pocket CDP,5562,2010,3552
1600000US0627190,0627190,"Fuller Acres CDP, California",Fuller Acres CDP,634,338,296
1600000US0628000,0628000,"Fullerton city, California",Fullerton city,137618,72492,65126
1600000US0628014,0628014,"Fulton CDP, California",Fulton CDP,413,250,163
1600000US0628021,0628021,"Furnace Creek CDP, California",Furnace Creek CDP,88,34,54
1600000US0628112,0628112,"Galt city, California",Galt city,26065,19410,6655
1600000US0628154,0628154,"Garberville CDP, California",Garberville CDP,1361,551,810
1600000US0628168,0628168,"Gardena city, California",Gardena city,58657,29447,29210
1600000US0628182,0628182,"Garden Acres CDP, California",Garden Acres CDP,10091,4943,5148
1600000US0628210,0628210,"Garden Farms CDP, California",Garden Farms CDP,418,297,121
1600000US0629000,0629000,"Garden Grove city, California",Garden Grove city,170795,92216,78579
1600000US0629070,0629070,"Garey CDP, California",Garey CDP,47,37,10
1600000US0629112,0629112,"Garnet CDP, California",Garnet CDP,5559,4660,899
1600000US0629154,0629154,"Gasquet CDP, California",Gasquet CDP,608,477,131
1600000US0629252,0629252,"Gazelle CDP, California",Gazelle CDP,111,63,48
1600000US0629350,0629350,"Georgetown CDP, California",Georgetown CDP,2827,2394,433
1600000US0629392,0629392,"Gerber CDP, California",Gerber CDP,1084,560,524
1600000US0629420,0629420,"Geyserville CDP, California",Geyserville CDP,671,407,264
1600000US0629504,0629504,"Gilroy city, California",Gilroy city,54815,35480,19335
1600000US0630000,0630000,"Glendale city, California",Glendale city,197554,71890,125664
1600000US0630014,0630014,"Glendora city, California",Glendora city,50098,35177,14921
1600000US0630028,0630028,"Glen Ellen CDP, California",Glen Ellen CDP,1214,1134,80
1600000US0630126,0630126,"Glennville CDP, California",Glennville CDP,54,26,28
1600000US0630282,0630282,"Golden Hills CDP, California",Golden Hills CDP,10229,8074,2155
1600000US0630339,0630339,"Gold Mountain CDP, California",Gold Mountain CDP,75,0,75
1600000US0630345,0630345,"Gold River CDP, California",Gold River CDP,7930,7223,707
1600000US0630378,0630378,"Goleta city, California",Goleta city,31907,17266,14641
1600000US0630392,0630392,"Gonzales city, California",Gonzales city,8340,4928,3412
1600000US0630410,0630410,"Good Hope CDP, California",Good Hope CDP,8407,4168,4239
1600000US0630412,0630412,"Goodmanville CDP, California",Goodmanville CDP,84,84,0
1600000US0630420,0630420,"Goodyears Bar CDP, California",Goodyears Bar CDP,80,22,58
1600000US0630476,0630476,"Goshen CDP, California",Goshen CDP,5387,3718,1669
1600000US0630560,0630560,"Graeagle CDP, California",Graeagle CDP,552,466,86
1600000US0630658,0630658,"Grand Terrace city, California",Grand Terrace city,12418,8397,4021
1600000US0630686,0630686,"Grangeville CDP, California",Grangeville CDP,324,295,29
1600000US0630693,0630693,"Granite Bay CDP, California",Granite Bay CDP,22739,21035,1704
1600000US0630703,0630703,"Granite Hills CDP, California",Granite Hills CDP,4009,3542,467
1600000US0630714,0630714,"Graniteville CDP, California",Graniteville CDP,14,14,0
1600000US0630798,0630798,"Grass Valley city, California",Grass Valley city,12206,4548,7658
1600000US0630812,0630812,"Graton CDP, California",Graton CDP,1722,1331,391
1600000US0630882,0630882,"Grayson CDP, California",Grayson CDP,1582,748,834
1600000US0630900,0630900,"Greeley Hill CDP, California",Greeley Hill CDP,919,754,165
1600000US0630938,0630938,"Greenacres CDP, California",Greenacres CDP,5247,3956,1291
1600000US0630944,0630944,"Green Acres CDP, California",Green Acres CDP,3845,3067,778
1600000US0630987,0630987,"Greenfield CDP, California",Greenfield CDP,3777,2076,1701
1600000US0630994,0630994,"Greenfield city, California",Greenfield city,17514,8744,8770
1600000US0631029,0631029,"Greenhorn CDP, California",Greenhorn CDP,202,124,78
1600000US0631092,0631092,"Green Valley CDP (Los Angeles County), California",Green Valley CDP (Los Angeles County),1096,799,297
1600000US0631099,0631099,"Green Valley CDP (Solano County), California",Green Valley CDP (Solano County),1583,1452,131
1600000US0631134,0631134,"Greenview CDP, California",Greenview CDP,139,52,87
1600000US0631162,0631162,"Greenville CDP, California",Greenville CDP,785,577,208
1600000US0631246,0631246,"Grenada CDP, California",Grenada CDP,295,98,197
1600000US0631260,0631260,"Gridley city, California",Gridley city,7065,3514,3551
1600000US0631288,0631288,"Grimes CDP, California",Grimes CDP,462,165,297
1600000US0631302,0631302,"Grizzly Flats CDP, California",Grizzly Flats CDP,1382,1221,161
1600000US0631372,0631372,"Groveland CDP, California",Groveland CDP,249,239,10
1600000US0631393,0631393,"Grover Beach city, California",Grover Beach city,13447,6415,7032
1600000US0631414,0631414,"Guadalupe city, California",Guadalupe city,7654,3381,4273
1600000US0631470,0631470,"Guerneville CDP, California",Guerneville CDP,4747,3167,1580
1600000US0631540,0631540,"Guinda CDP, California",Guinda CDP,113,59,54
1600000US0631568,0631568,"Gustine city, California",Gustine city,5748,2769,2979
1600000US0631596,0631596,"Hacienda Heights CDP, California",Hacienda Heights CDP,55205,42235,12970
1600000US0631708,0631708,"Half Moon Bay city, California",Half Moon Bay city,12583,7959,4624
1600000US0631883,0631883,"Hamilton Branch CDP, California",Hamilton Branch CDP,446,403,43
1600000US0631890,0631890,"Hamilton City CDP, California",Hamilton City CDP,2446,1297,1149
1600000US0631960,0631960,"Hanford city, California",Hanford city,56868,33808,23060
1600000US0632030,0632030,"Happy Camp CDP, California",Happy Camp CDP,845,451,394
1600000US0632036,0632036,"Happy Valley CDP, California",Happy Valley CDP,5633,4560,1073
1600000US0632044,0632044,"Harbison Canyon CDP, California",Harbison Canyon CDP,4352,4056,296
1600000US0632156,0632156,"Hardwick CDP, California",Hardwick CDP,152,45,107
1600000US0632212,0632212,"Harmony Grove CDP, California",Harmony Grove CDP,1494,1083,411
1600000US0632324,0632324,"Hartland CDP, California",Hartland CDP,0,0,0
1600000US0632340,0632340,"Hartley CDP, California",Hartley CDP,2650,2301,349
1600000US0632385,0632385,"Hasley Canyon CDP, California",Hasley Canyon CDP,1433,1307,126
1600000US0632408,0632408,"Hat Creek CDP, California",Hat Creek CDP,77,77,0
1600000US0632506,0632506,"Hawaiian Gardens city, California",Hawaiian Gardens city,14189,6068,8121
1600000US0632548,0632548,"Hawthorne city, California",Hawthorne city,84744,25235,59509
1600000US0632562,0632562,"Hayfork CDP, California",Hayfork CDP,2561,1266,1295
1600000US0633000,0633000,"Hayward city, California",Hayward city,155303,86598,68705
1600000US0633056,0633056,"Healdsburg city, California",Healdsburg city,11863,6234,5629
1600000US0633084,0633084,"Heber CDP, California",Heber CDP,8413,5253,3160
1600000US0633182,0633182,"Hemet city, California",Hemet city,83903,50757,33146
1600000US0633294,0633294,"Herald CDP, California",Herald CDP,986,866,120
1600000US0633308,0633308,"Hercules city, California",Hercules city,26025,20742,5283
1600000US0633336,0633336,"Herlong CDP, California",Herlong CDP,315,0,315
1600000US0633364,0633364,"Hermosa Beach city, California",Hermosa Beach city,19142,10381,8761
1600000US0633434,0633434,"Hesperia city, California",Hesperia city,95010,58792,36218
1600000US0633504,0633504,"Hickman CDP, California",Hickman CDP,751,548,203
1600000US0633518,0633518,"Hidden Hills city, California",Hidden Hills city,2218,1953,265
1600000US0633532,0633532,"Hidden Meadows CDP, California",Hidden Meadows CDP,3663,3281,382
1600000US0633549,0633549,"Hidden Valley Lake CDP, California",Hidden Valley Lake CDP,5948,4035,1913
1600000US0633574,0633574,"Highgrove CDP, California",Highgrove CDP,6192,4059,2133
1600000US0633588,0633588,"Highland city, California",Highland city,55184,36232,18952
1600000US0633632,0633632,"Highlands CDP, California",Highlands CDP,2810,2416,394
1600000US0633689,0633689,"Hillcrest CDP, California",Hillcrest CDP,11747,5851,5896
1600000US0633798,0633798,"Hillsborough town, California",Hillsborough town,11608,10992,616
1600000US0633861,0633861,"Hilmar-Irwin CDP, California",Hilmar-Irwin CDP,5937,3817,2120
1600000US0633935,0633935,"Hiouchi CDP, California",Hiouchi CDP,266,266,0
1600000US0634120,0634120,"Hollister city, California",Hollister city,39982,24912,15070
1600000US0634246,0634246,"Holtville city, California",Holtville city,6129,3180,2949
1600000US0634281,0634281,"Home Garden CDP, California",Home Garden CDP,1590,800,790
1600000US0634302,0634302,"Home Gardens CDP, California",Home Gardens CDP,12014,8701,3313
1600000US0634316,0634316,"Homeland CDP, California",Homeland CDP,7598,5604,1994
1600000US0634392,0634392,"Homestead Valley CDP, California",Homestead Valley CDP,2619,1953,666
1600000US0634405,0634405,"Homewood Canyon CDP, California",Homewood Canyon CDP,241,232,9
1600000US0634428,0634428,"Honcut CDP, California",Honcut CDP,172,98,74
1600000US0634484,0634484,"Hood CDP, California",Hood CDP,289,239,50
1600000US0634540,0634540,"Hoopa CDP, California",Hoopa CDP,3319,2315,1004
1600000US0634652,0634652,"Hopland CDP, California",Hopland CDP,899,373,526
1600000US0634694,0634694,"Hornbrook CDP, California",Hornbrook CDP,243,141,102
1600000US0634708,0634708,"Hornitos CDP, California",Hornitos CDP,74,74,0
1600000US0634904,0634904,"Hughson city, California",Hughson city,7541,5211,2330
1600000US0634928,0634928,"Humboldt Hill CDP, California",Humboldt Hill CDP,3193,2504,689
1600000US0636000,0636000,"Huntington Beach city, California",Huntington Beach city,198780,113458,85322
1600000US0636056,0636056,"Huntington Park city, California",Huntington Park city,57615,17152,40463
1600000US0636084,0636084,"Huron city, California",Huron city,7084,1589,5495
1600000US0636098,0636098,"Hyampom CDP, California",Hyampom CDP,124,79,45
1600000US0636126,0636126,"Hydesville CDP, California",Hydesville CDP,1051,936,115
1600000US0636135,0636135,"Hypericum CDP, California",Hypericum CDP,160,133,27
1600000US0636168,0636168,"Idlewild CDP, California",Idlewild CDP,0,0,0
1600000US0636203,0636203,"Idyllwild-Pine Cove CDP, California",Idyllwild-Pine Cove CDP,2955,1917,1038
1600000US0636252,0636252,"Igo CDP, California",Igo CDP,148,148,0
1600000US0636280,0636280,"Imperial city, California",Imperial city,18601,13479,5122
1600000US0636294,0636294,"Imperial Beach city, California",Imperial Beach city,26312,7818,18494
1600000US0636350,0636350,"Independence CDP, California",Independence CDP,692,525,167
1600000US0636364,0636364,"Indian Falls CDP, California",Indian Falls CDP,10,10,0
1600000US0636420,0636420,"Indianola CDP, California",Indianola CDP,660,432,228
1600000US0636434,0636434,"Indian Wells city, California",Indian Wells city,5454,4493,961
1600000US0636448,0636448,"Indio city, California",Indio city,89070,64759,24311
1600000US0636452,0636452,"Indio Hills CDP, California",Indio Hills CDP,801,781,20
1600000US0636490,0636490,"Industry city, California",Industry city,249,26,223
1600000US0636546,0636546,"Inglewood city, California",Inglewood city,107254,41223,66031
1600000US0636613,0636613,"Interlaken CDP, California",Interlaken CDP,7392,5186,2206
1600000US0636616,0636616,"Inverness CDP, California",Inverness CDP,1497,1200,297
1600000US0636658,0636658,"Inyokern CDP, California",Inyokern CDP,645,445,200
1600000US0636672,0636672,"Ione city, California",Ione city,7351,5826,1525
1600000US0636735,0636735,"Iron Horse CDP, California",Iron Horse CDP,290,290,0
1600000US0636770,0636770,"Irvine city, California",Irvine city,265079,124744,140335
1600000US0636826,0636826,"Irwindale city, California",Irwindale city,1365,1104,261
1600000US0636868,0636868,"Isla Vista CDP, California",Isla Vista CDP,14286,67,14219
1600000US0636882,0636882,"Isleton city, California",Isleton city,495,298,197
1600000US0636910,0636910,"Ivanhoe CDP, California",Ivanhoe CDP,4584,1973,2611
1600000US0636980,0636980,"Jackson city, California",Jackson city,4637,2555,2082
1600000US0637022,0637022,"Jacumba CDP, California",Jacumba CDP,579,189,390
1600000US0637106,0637106,"Jamestown CDP, California",Jamestown CDP,3379,2057,1322
1600000US0637120,0637120,"Jamul CDP, California",Jamul CDP,5754,5258,496
1600000US0637134,0637134,"Janesville CDP, California",Janesville CDP,2790,1947,843
1600000US0637274,0637274,"Jenner CDP, California",Jenner CDP,31,15,16
1600000US0637400,0637400,"Johannesburg CDP, California",Johannesburg CDP,48,23,25
1600000US0637442,0637442,"Johnson Park CDP, California",Johnson Park CDP,815,331,484
1600000US0637484,0637484,"Johnstonville CDP, California",Johnstonville CDP,1151,982,169
1600000US0637512,0637512,"Johnsville CDP, California",Johnsville CDP,0,0,0
1600000US0637533,0637533,"Jones Valley CDP, California",Jones Valley CDP,1269,1022,247
1600000US0637554,0637554,"Joshua Tree CDP, California",Joshua Tree CDP,7644,3976,3668
1600000US0637568,0637568,"Jovista CDP, California",Jovista CDP,93,84,9
1600000US0637582,0637582,"Julian CDP, California",Julian CDP,1318,1103,215
1600000US0637596,0637596,"Junction City CDP, California",Junction City CDP,744,690,54
1600000US0637624,0637624,"June Lake CDP, California",June Lake CDP,413,369,44
1600000US0637692,0637692,"Jurupa Valley city, California",Jurupa Valley city,105793,75151,30642
1600000US0637904,0637904,"Keddie CDP, California",Keddie CDP,68,30,38
1600000US0637918,0637918,"Keeler CDP, California",Keeler CDP,6,6,0
1600000US0637946,0637946,"Keene CDP, California",Keene CDP,257,216,41
1600000US0638024,0638024,"Kelly Ridge CDP, California",Kelly Ridge CDP,2932,2446,486
1600000US0638044,0638044,"Kelseyville CDP, California",Kelseyville CDP,3657,1599,2058
1600000US0638065,0638065,"Kennedy CDP, California",Kennedy CDP,2838,1535,1303
1600000US0638076,0638076,"Kennedy Meadows CDP, California",Kennedy Meadows CDP,143,143,0
1600000US0638086,0638086,"Kensington CDP, California",Kensington CDP,5163,4384,779
1600000US0638114,0638114,"Kentfield CDP, California",Kentfield CDP,7396,6197,1199
1600000US0638156,0638156,"Kenwood CDP, California",Kenwood CDP,530,488,42
1600000US0638177,0638177,"Kep'el CDP, California",Kep'el CDP,26,15,11
1600000US0638226,0638226,"Kerman city, California",Kerman city,14909,7939,6970
1600000US0638310,0638310,"Kernville CDP, California",Kernville CDP,774,531,243
1600000US0638352,0638352,"Keswick CDP, California",Keswick CDP,192,64,128
1600000US0638394,0638394,"Kettleman City CDP, California",Kettleman City CDP,1245,349,896
1600000US0638422,0638422,"Keyes CDP, California",Keyes CDP,5691,3318,2373
1600000US0638520,0638520,"King City city, California",King City city,13787,4681,9106
1600000US0638548,0638548,"Kings Beach CDP, California",Kings Beach CDP,2826,1701,1125
1600000US0638562,0638562,"Kingsburg city, California",Kingsburg city,12028,8721,3307
1600000US0638604,0638604,"Kingvale CDP, California",Kingvale CDP,102,102,0
1600000US0638646,0638646,"Kirkwood CDP, California",Kirkwood CDP,121,109,12
1600000US0638702,0638702,"Klamath CDP, California",Klamath CDP,964,656,308
1600000US0638772,0638772,"Knightsen CDP, California",Knightsen CDP,1100,928,172
1600000US0638786,0638786,"Knights Ferry CDP, California",Knights Ferry CDP,62,53,9
1600000US0638800,0638800,"Knights Landing CDP, California",Knights Landing CDP,981,629,352
1600000US0639003,0639003,"La Cañada Flintridge city, California",La Cañada Flintridge city,20032,17640,2392
1600000US0639045,0639045,"La Crescenta-Montrose CDP, California",La Crescenta-Montrose CDP,20166,13744,6422
1600000US0639052,0639052,"La Cresta CDP, California",La Cresta CDP,9964,3721,6243
1600000US0639094,0639094,"Ladera CDP, California",Ladera CDP,1385,1385,0
1600000US0639108,0639108,"Ladera Heights CDP, California",Ladera Heights CDP,6404,5116,1288
1600000US0639114,0639114,"Ladera Ranch CDP, California",Ladera Ranch CDP,24996,18338,6658
1600000US0639122,0639122,"Lafayette city, California",Lafayette city,25829,19480,6349
1600000US0639164,0639164,"La Grange CDP, California",La Grange CDP,143,38,105
1600000US0639178,0639178,"Laguna Beach city, California",Laguna Beach city,22930,15440,7490
1600000US0639220,0639220,"Laguna Hills city, California",Laguna Hills city,31143,22400,8743
1600000US0639248,0639248,"Laguna Niguel city, California",Laguna Niguel city,64691,43409,21282
1600000US0639259,0639259,"Laguna Woods city, California",Laguna Woods city,15999,11509,4490
1600000US0639283,0639283,"Lagunitas-Forest Knolls CDP, California",Lagunitas-Forest Knolls CDP,1860,1181,679
1600000US0639290,0639290,"La Habra city, California",La Habra city,62331,35243,27088
1600000US0639304,0639304,"La Habra Heights city, California",La Habra Heights city,5293,4664,629
1600000US0639318,0639318,"La Honda CDP, California",La Honda CDP,1215,906,309
1600000US0639411,0639411,"Lake Almanor Country Club CDP, California",Lake Almanor Country Club CDP,429,333,96
1600000US0639420,0639420,"Lake Almanor Peninsula CDP, California",Lake Almanor Peninsula CDP,382,365,17
1600000US0639425,0639425,"Lake Almanor West CDP, California",Lake Almanor West CDP,329,290,39
1600000US0639444,0639444,"Lake Arrowhead CDP, California",Lake Arrowhead CDP,9699,7165,2534
1600000US0639460,0639460,"Lake California CDP, California",Lake California CDP,3276,1957,1319
1600000US0639472,0639472,"Lake City CDP, California",Lake City CDP,86,84,2
1600000US0639483,0639483,"Lake Davis CDP, California",Lake Davis CDP,91,80,11
1600000US0639484,0639484,"Lake Don Pedro CDP, California",Lake Don Pedro CDP,1465,1279,186
1600000US0639486,0639486,"Lake Elsinore city, California",Lake Elsinore city,64182,45289,18893
1600000US0639496,0639496,"Lake Forest city, California",Lake Forest city,84111,60201,23910
1600000US0639514,0639514,"Lakehead CDP, California",Lakehead CDP,615,501,114
1600000US0639556,0639556,"Lake Hughes CDP, California",Lake Hughes CDP,660,565,95
1600000US0639570,0639570,"Lake Isabella CDP, California",Lake Isabella CDP,3621,1559,2062
1600000US0639598,0639598,"Lakeland Village CDP, California",Lakeland Village CDP,12357,7229,5128
1600000US0639612,0639612,"Lake Los Angeles CDP, California",Lake Los Angeles CDP,11880,7811,4069
1600000US0639645,0639645,"Lake Mathews CDP, California",Lake Mathews CDP,7359,6033,1326
1600000US0639670,0639670,"Lake Nacimiento CDP, California",Lake Nacimiento CDP,3021,2574,447
1600000US0639690,0639690,"Lake of the Pines CDP, California",Lake of the Pines CDP,4350,3721,629
1600000US0639696,0639696,"Lake of the Woods CDP, California",Lake of the Woods CDP,757,540,217
1600000US0639710,0639710,"Lakeport city, California",Lakeport city,4810,3578,1232
1600000US0639715,0639715,"Lake Riverside CDP, California",Lake Riverside CDP,1139,1139,0
1600000US0639724,0639724,"Lake San Marcos CDP, California",Lake San Marcos CDP,3957,2976,981
1600000US0639728,0639728,"Lake Shastina CDP, California",Lake Shastina CDP,2790,2117,673
1600000US0639735,0639735,"Lake Sherwood CDP, California",Lake Sherwood CDP,1697,1369,328
1600000US0639759,0639759,"Lakeside CDP (Kern County), California",Lakeside CDP (Kern County),969,893,76
1600000US0639766,0639766,"Lakeside CDP (San Diego County), California",Lakeside CDP (San Diego County),20818,14263,6555
1600000US0639836,0639836,"Lakeview CDP, California",Lakeview CDP,2447,1543,904
1600000US0639885,0639885,"Lake Wildwood CDP, California",Lake Wildwood CDP,4704,3636,1068
1600000US0639892,0639892,"Lakewood city, California",Lakewood city,79550,58827,20723
1600000US0640004,0640004,"La Mesa city, California",La Mesa city,59433,26934,32499
1600000US0640032,0640032,"La Mirada city, California",La Mirada city,45341,36150,9191
1600000US0640088,0640088,"Lamont CDP, California",Lamont CDP,14724,6674,8050
1600000US0640116,0640116,"Lanare CDP, California",Lanare CDP,241,102,139
1600000US0640130,0640130,"Lancaster city, California",Lancaster city,150783,82678,68105
1600000US0640256,0640256,"La Palma city, California",La Palma city,15613,10340,5273
1600000US0640312,0640312,"La Porte CDP, California",La Porte CDP,0,0,0
1600000US0640326,0640326,"La Presa CDP, California",La Presa CDP,37073,24486,12587
1600000US0640340,0640340,"La Puente city, California",La Puente city,39691,23534,16157
1600000US0640354,0640354,"La Quinta city, California",La Quinta city,41578,29364,12214
1600000US0640410,0640410,"La Riviera CDP, California",La Riviera CDP,11470,6523,4947
1600000US0640426,0640426,"Larkfield-Wikiup CDP, California",Larkfield-Wikiup CDP,8026,4902,3124
1600000US0640438,0640438,"Larkspur city, California",Larkspur city,12235,7024,5211
1600000US0640508,0640508,"La Selva Beach CDP, California",La Selva Beach CDP,2519,1351,1168
1600000US0640526,0640526,"Las Flores CDP (Orange County), California",Las Flores CDP (Orange County),5089,3876,1213
1600000US0640536,0640536,"Las Flores CDP (Tehama County), California",Las Flores CDP (Tehama County),217,26,191
1600000US0640592,0640592,"Las Lomas CDP, California",Las Lomas CDP,3818,2050,1768
1600000US0640704,0640704,"Lathrop city, California",Lathrop city,23841,18750,5091
1600000US0640746,0640746,"Laton CDP, California",Laton CDP,1967,1005,962
1600000US0640830,0640830,"La Verne city, California",La Verne city,31610,24282,7328
1600000US0640872,0640872,"La Vina CDP, California",La Vina CDP,203,203,0
1600000US0640886,0640886,"Lawndale city, California",Lawndale city,32389,13107,19282
1600000US0640928,0640928,"Laytonville CDP, California",Laytonville CDP,777,337,440
1600000US0640956,0640956,"Lebec CDP, California",Lebec CDP,1474,1051,423
1600000US0640998,0640998,"Lee Vining CDP, California",Lee Vining CDP,46,0,46
1600000US0641026,0641026,"Leggett CDP, California",Leggett CDP,56,47,9
1600000US0641040,0641040,"Le Grand CDP, California",Le Grand CDP,1597,997,600
1600000US0641110,0641110,"Lemon Cove CDP, California",Lemon Cove CDP,263,240,23
1600000US0641124,0641124,"Lemon Grove city, California",Lemon Grove city,26537,14989,11548
1600000US0641142,0641142,"Lemon Hill CDP, California",Lemon Hill CDP,15065,4761,10304
1600000US0641152,0641152,"Lemoore city, California",Lemoore city,25852,14544,11308
1600000US0641166,0641166,"Lemoore Station CDP, California",Lemoore Station CDP,4853,0,4853
1600000US0641180,0641180,"Lennox CDP, California",Lennox CDP,22471,7023,15448
1600000US0641194,0641194,"Lenwood CDP, California",Lenwood CDP,4431,1951,2480
1600000US0641208,0641208,"Leona Valley CDP, California",Leona Valley CDP,1672,1585,87
1600000US0641278,0641278,"Lewiston CDP, California",Lewiston CDP,1478,1080,398
1600000US0641282,0641282,"Lexington Hills CDP, California",Lexington Hills CDP,2643,2493,150
1600000US0641390,0641390,"Likely CDP, California",Likely CDP,0,0,0
1600000US0641474,0641474,"Lincoln city, California",Lincoln city,47998,38645,9353
1600000US0641558,0641558,"Lincoln Village CDP, California",Lincoln Village CDP,3980,2387,1593
1600000US0641572,0641572,"Linda CDP, California",Linda CDP,21808,10649,11159
1600000US0641656,0641656,"Lindcove CDP, California",Lindcove CDP,73,73,0
1600000US0641670,0641670,"Linden CDP, California",Linden CDP,2043,1447,596
1600000US0641712,0641712,"Lindsay city, California",Lindsay city,12701,7034,5667
1600000US0641740,0641740,"Linnell Camp CDP, California",Linnell Camp CDP,837,0,837
1600000US0641782,0641782,"Litchfield CDP, California",Litchfield CDP,183,155,28
1600000US0641789,0641789,"Little Grass Valley CDP, California",Little Grass Valley CDP,0,0,0
1600000US0641866,0641866,"Little River CDP, California",Little River CDP,176,77,99
1600000US0641880,0641880,"Littlerock CDP, California",Littlerock CDP,948,495,453
1600000US0641908,0641908,"Little Valley CDP, California",Little Valley CDP,19,8,11
1600000US0641922,0641922,"Live Oak CDP, California",Live Oak CDP,15873,9491,6382
1600000US0641936,0641936,"Live Oak city, California",Live Oak city,8677,5235,3442
1600000US0641992,0641992,"Livermore city, California",Livermore city,91339,67099,24240
1600000US0642006,0642006,"Livingston city, California",Livingston city,14386,8886,5500
1600000US0642104,0642104,"Lockeford CDP, California",Lockeford CDP,3555,2544,1011
1600000US0642142,0642142,"Lockwood CDP (Amador County), California",Lockwood CDP (Amador County),451,444,7
1600000US0642146,0642146,"Lockwood CDP (Monterey County), California",Lockwood CDP (Monterey County),351,177,174
1600000US0642202,0642202,"Lodi city, California",Lodi city,65861,34112,31749
1600000US0642230,0642230,"Lodoga CDP, California",Lodoga CDP,184,86,98
1600000US0642328,0642328,"Loleta CDP, California",Loleta CDP,599,330,269
1600000US0642370,0642370,"Loma Linda city, California",Loma Linda city,23046,9950,13096
1600000US0642384,0642384,"Loma Mar CDP, California",Loma Mar CDP,282,183,99
1600000US0642412,0642412,"Loma Rica CDP, California",Loma Rica CDP,2909,2315,594
1600000US0642468,0642468,"Lomita city, California",Lomita city,20029,9122,10907
1600000US0642510,0642510,"Lompico CDP, California",Lompico CDP,881,778,103
1600000US0642524,0642524,"Lompoc city, California",Lompoc city,39636,17316,22320
1600000US0642566,0642566,"London CDP, California",London CDP,1534,331,1203
1600000US0642580,0642580,"Lone Pine CDP, California",Lone Pine CDP,1436,829,607
1600000US0642622,0642622,"Long Barn CDP, California",Long Barn CDP,88,0,88
1600000US0643000,0643000,"Long Beach city, California",Long Beach city,452816,190197,262619
1600000US0643126,0643126,"Lookout CDP, California",Lookout CDP,50,22,28
1600000US0643140,0643140,"Loomis town, California",Loomis town,6767,5183,1584
1600000US0643224,0643224,"Los Alamitos city, California",Los Alamitos city,11334,4975,6359
1600000US0643252,0643252,"Los Alamos CDP, California",Los Alamos CDP,1254,883,371
1600000US0643280,0643280,"Los Altos city, California",Los Altos city,30593,24949,5644
1600000US0643294,0643294,"Los Altos Hills town, California",Los Altos Hills town,8417,7612,805
1600000US0644000,0644000,"Los Angeles city, California",Los Angeles city,3883012,1576486,2306526
1600000US0644028,0644028,"Los Banos city, California",Los Banos city,39304,22239,17065
1600000US0644042,0644042,"Los Berros CDP, California",Los Berros CDP,296,296,0
1600000US0644112,0644112,"Los Gatos town, California",Los Gatos town,31548,22350,9198
1600000US0644140,0644140,"Los Molinos CDP, California",Los Molinos CDP,1924,989,935
1600000US0644168,0644168,"Los Olivos CDP, California",Los Olivos CDP,838,629,209
1600000US0644182,0644182,"Los Osos CDP, California",Los Osos CDP,16041,11404,4637
1600000US0644242,0644242,"Los Ranchos CDP, California",Los Ranchos CDP,1675,1502,173
1600000US0644280,0644280,"Lost Hills CDP, California",Lost Hills CDP,1742,678,1064
1600000US0644350,0644350,"Lower Lake CDP, California",Lower Lake CDP,1060,638,422
1600000US0644364,0644364,"Loyalton city, California",Loyalton city,1037,666,371
1600000US0644378,0644378,"Loyola CDP, California",Loyola CDP,3404,3090,314
1600000US0644399,0644399,"Lucas Valley-Marinwood CDP, California",Lucas Valley-Marinwood CDP,6627,5840,787
1600000US0644406,0644406,"Lucerne CDP, California",Lucerne CDP,2674,1890,784
1600000US0644420,0644420,"Lucerne Valley CDP, California",Lucerne Valley CDP,5632,3759,1873
1600000US0644574,0644574,"Lynwood city, California",Lynwood city,66617,34317,32300
1600000US0644644,0644644,"Lytle Creek CDP, California",Lytle Creek CDP,644,475,169
1600000US0644672,0644672,"Mabie CDP, California",Mabie CDP,72,72,0
1600000US0644700,0644700,"McArthur CDP, California",McArthur CDP,521,246,275
1600000US0644760,0644760,"McClellan Park CDP, California",McClellan Park CDP,747,0,747
1600000US0644770,0644770,"McClenney Tract CDP, California",McClenney Tract CDP,38,18,20
1600000US0644784,0644784,"McCloud CDP, California",McCloud CDP,894,586,308
1600000US0644812,0644812,"Macdoel CDP, California",Macdoel CDP,26,0,26
1600000US0644826,0644826,"McFarland city, California",McFarland city,12000,6452,5548
1600000US0644830,0644830,"McGee Creek CDP, California",McGee Creek CDP,0,0,0
1600000US0644910,0644910,"McKinleyville CDP, California",McKinleyville CDP,16640,11538,5102
1600000US0644924,0644924,"McKittrick CDP, California",McKittrick CDP,130,83,47
1600000US0645006,0645006,"McSwain CDP, California",McSwain CDP,4429,3865,564
1600000US0645008,0645008,"Madeline CDP, California",Madeline CDP,11,11,0
1600000US0645022,0645022,"Madera city, California",Madera city,64709,31146,33563
1600000US0645050,0645050,"Madera Acres CDP, California",Madera Acres CDP,9973,9086,887
1600000US0645054,0645054,"Madera Ranchos CDP, California",Madera Ranchos CDP,3584,3011,573
1600000US0645064,0645064,"Madison CDP, California",Madison CDP,497,344,153
1600000US0645092,0645092,"Mad River CDP, California",Mad River CDP,341,258,83
1600000US0645120,0645120,"Magalia CDP, California",Magalia CDP,11425,8688,2737
1600000US0645232,0645232,"Malaga CDP, California",Malaga CDP,1168,515,653
1600000US0645246,0645246,"Malibu city, California",Malibu city,12179,9795,2384
1600000US0645358,0645358,"Mammoth Lakes town, California",Mammoth Lakes town,8110,4389,3721
1600000US0645386,0645386,"Manchester CDP, California",Manchester CDP,267,108,159
1600000US0645400,0645400,"Manhattan Beach city, California",Manhattan Beach city,35038,25729,9309
1600000US0645414,0645414,"Manila CDP, California",Manila CDP,754,305,449
1600000US0645484,0645484,"Manteca city, California",Manteca city,80456,54018,26438
1600000US0645512,0645512,"Manton CDP, California",Manton CDP,320,231,89
1600000US0645680,0645680,"March ARB CDP, California",March ARB CDP,1174,8,1166
1600000US0645736,0645736,"Maricopa city, California",Maricopa city,2157,1135,1022
1600000US0645778,0645778,"Marina city, California",Marina city,20966,8675,12291
1600000US0645806,0645806,"Marina del Rey CDP, California",Marina del Rey CDP,10065,362,9703
1600000US0645820,0645820,"Marin City CDP, California",Marin City CDP,3040,959,2081
1600000US0645932,0645932,"Mariposa CDP, California",Mariposa CDP,1093,612,481
1600000US0645988,0645988,"Markleeville CDP, California",Markleeville CDP,187,142,45
1600000US0646100,0646100,"Martell CDP, California",Martell CDP,113,48,65
1600000US0646114,0646114,"Martinez city, California",Martinez city,37816,27082,10734
1600000US0646170,0646170,"Marysville city, California",Marysville city,11864,6680,5184
1600000US0646223,0646223,"Matheny CDP, California",Matheny CDP,1036,342,694
1600000US0646226,0646226,"Mather CDP, California",Mather CDP,4301,3752,549
1600000US0646338,0646338,"Maxwell CDP, California",Maxwell CDP,1256,742,514
1600000US0646400,0646400,"Mayfair CDP, California",Mayfair CDP,4856,2030,2826
1600000US0646436,0646436,"Mayflower Village CDP, California",Mayflower Village CDP,5682,4206,1476
1600000US0646492,0646492,"Maywood city, California",Maywood city,27000,7886,19114
1600000US0646520,0646520,"Meadowbrook CDP, California",Meadowbrook CDP,4199,2432,1767
1600000US0646618,0646618,"Meadow Valley CDP, California",Meadow Valley CDP,478,478,0
1600000US0646632,0646632,"Meadow Vista CDP, California",Meadow Vista CDP,3508,3033,475
1600000US0646646,0646646,"Mead Valley CDP, California",Mead Valley CDP,20583,15981,4602
1600000US0646660,0646660,"Mecca CDP, California",Mecca CDP,5541,3491,2050
1600000US0646702,0646702,"Meiners Oaks CDP, California",Meiners Oaks CDP,3697,2295,1402
1600000US0646814,0646814,"Mendocino CDP, California",Mendocino CDP,639,325,314
1600000US0646828,0646828,"Mendota city, California",Mendota city,12173,6303,5870
1600000US0646842,0646842,"Menifee city, California",Menifee city,92797,73906,18891
1600000US0646870,0646870,"Menlo Park city, California",Menlo Park city,34106,21441,12665
1600000US0646884,0646884,"Mentone CDP, California",Mentone CDP,10055,6944,3111
1600000US0646898,0646898,"Merced city, California",Merced city,82992,34148,48844
1600000US0646926,0646926,"Meridian CDP, California",Meridian CDP,278,186,92
1600000US0647013,0647013,"Mesa CDP, California",Mesa CDP,434,385,49
1600000US0647066,0647066,"Mesa Verde CDP, California",Mesa Verde CDP,753,676,77
1600000US0647086,0647086,"Mesa Vista CDP, California",Mesa Vista CDP,211,205,6
1600000US0647164,0647164,"Mettler CDP, California",Mettler CDP,115,52,63
1600000US0647192,0647192,"Mexican Colony CDP, California",Mexican Colony CDP,337,117,220
1600000US0647206,0647206,"Meyers CDP, California",Meyers CDP,2288,1871,417
1600000US0647332,0647332,"Middletown CDP, California",Middletown CDP,725,242,483
1600000US0647374,0647374,"Midpines CDP, California",Midpines CDP,309,193,116
1600000US0647430,0647430,"Midway City CDP, California",Midway City CDP,8631,2529,6102
1600000US0647472,0647472,"Milford CDP, California",Milford CDP,117,117,0
1600000US0647486,0647486,"Millbrae city, California",Millbrae city,22756,14246,8510
1600000US0647592,0647592,"Millerton CDP, California",Millerton CDP,679,679,0
1600000US0647710,0647710,"Mill Valley city, California",Mill Valley city,14385,10012,4373
1600000US0647724,0647724,"Millville CDP, California",Millville CDP,879,642,237
1600000US0647766,0647766,"Milpitas city, California",Milpitas city,72748,46328,26420
1600000US0647794,0647794,"Mineral CDP, California",Mineral CDP,250,100,150
1600000US0647822,0647822,"Minkler CDP, California",Minkler CDP,968,927,41
1600000US0648046,0648046,"Mira Monte CDP, California",Mira Monte CDP,6760,5827,933
1600000US0648060,0648060,"Miranda CDP, California",Miranda CDP,490,222,268
1600000US0648147,0648147,"Mission Canyon CDP, California",Mission Canyon CDP,2649,2192,457
1600000US0648186,0648186,"Mission Hills CDP, California",Mission Hills CDP,3509,2459,1050
1600000US0648256,0648256,"Mission Viejo city, California",Mission Viejo city,94036,72272,21764
1600000US0648298,0648298,"Mi-Wuk Village CDP, California",Mi-Wuk Village CDP,933,735,198
1600000US0648354,0648354,"Modesto city, California",Modesto city,211775,117174,94601
1600000US0648410,0648410,"Modjeska CDP, California",Modjeska CDP,821,702,119
1600000US0648448,0648448,"Mohawk Vista CDP, California",Mohawk Vista CDP,53,43,10
1600000US0648452,0648452,"Mojave CDP, California",Mojave CDP,3780,1218,2562
1600000US0648480,0648480,"Mokelumne Hill CDP, California",Mokelumne Hill CDP,484,451,33
1600000US0648592,0648592,"Monmouth CDP, California",Monmouth CDP,113,92,21
1600000US0648602,0648602,"Mono City CDP, California",Mono City CDP,135,56,79
1600000US0648641,0648641,"Mono Vista CDP, California",Mono Vista CDP,3574,2756,818
1600000US0648648,0648648,"Monrovia city, California",Monrovia city,37423,16956,20467
1600000US0648676,0648676,"Monson CDP, California",Monson CDP,210,173,37
1600000US0648690,0648690,"Montague city, California",Montague city,1491,907,584
1600000US0648718,0648718,"Montalvin Manor CDP, California",Montalvin Manor CDP,2478,1531,947
1600000US0648760,0648760,"Montara CDP, California",Montara CDP,2833,2489,344
1600000US0648788,0648788,"Montclair city, California",Montclair city,39724,21801,17923
1600000US0648816,0648816,"Montebello city, California",Montebello city,62232,26963,35269
1600000US0648844,0648844,"Montecito CDP, California",Montecito CDP,7128,5153,1975
1600000US0648872,0648872,"Monterey city, California",Monterey city,26021,8732,17289
1600000US0648914,0648914,"Monterey Park city, California",Monterey Park city,60342,30348,29994
1600000US0648916,0648916,"Monterey Park Tract CDP, California",Monterey Park Tract CDP,293,69,224
1600000US0648928,0648928,"Monte Rio CDP, California",Monte Rio CDP,1023,704,319
1600000US0648956,0648956,"Monte Sereno city, California",Monte Sereno city,3511,3361,150
1600000US0648998,0648998,"Montgomery Creek CDP, California",Montgomery Creek CDP,98,85,13
1600000US0649045,0649045,"Monument Hills CDP, California",Monument Hills CDP,1354,1257,97
1600000US0649138,0649138,"Moorpark city, California",Moorpark city,36443,29018,7425
1600000US0649180,0649180,"Morada CDP, California",Morada CDP,3384,3172,212
1600000US0649187,0649187,"Moraga town, California",Moraga town,14984,12295,2689
1600000US0649270,0649270,"Moreno Valley city, California",Moreno Valley city,207990,130769,77221
1600000US0649278,0649278,"Morgan Hill city, California",Morgan Hill city,44354,31199,13155
1600000US0649348,0649348,"Morongo Valley CDP, California",Morongo Valley CDP,3164,2436,728
1600000US0649362,0649362,"Morro Bay city, California",Morro Bay city,10445,6462,3983
1600000US0649432,0649432,"Moskowite Corner CDP, California",Moskowite Corner CDP,69,64,5
1600000US0649446,0649446,"Moss Beach CDP, California",Moss Beach CDP,3307,2743,564
1600000US0649488,0649488,"Moss Landing CDP, California",Moss Landing CDP,25,25,0
1600000US0649544,0649544,"Mountain Center CDP, California",Mountain Center CDP,17,0,17
1600000US0649558,0649558,"Mountain Gate CDP, California",Mountain Gate CDP,703,499,204
1600000US0649582,0649582,"Mountain House CDP, California",Mountain House CDP,21387,16146,5241
1600000US0649592,0649592,"Mountain Meadows CDP, California",Mountain Meadows CDP,251,251,0
1600000US0649600,0649600,"Mountain Mesa CDP, California",Mountain Mesa CDP,954,856,98
1600000US0649628,0649628,"Mountain Ranch CDP, California",Mountain Ranch CDP,318,285,33
1600000US0649651,0649651,"Mountain View CDP, California",Mountain View CDP,1830,1146,684
1600000US0649670,0649670,"Mountain View city, California",Mountain View city,79814,35148,44666
1600000US0649684,0649684,"Mountain View Acres CDP, California",Mountain View Acres CDP,3684,2657,1027
1600000US0649726,0649726,"Mt. Bullion CDP, California",Mt. Bullion CDP,105,92,13
1600000US0649768,0649768,"Mount Hebron CDP, California",Mount Hebron CDP,61,12,49
1600000US0649796,0649796,"Mount Hermon CDP, California",Mount Hermon CDP,1394,968,426
1600000US0649810,0649810,"Mount Laguna CDP, California",Mount Laguna CDP,102,102,0
1600000US0649852,0649852,"Mount Shasta city, California",Mount Shasta city,3243,1373,1870
1600000US0649950,0649950,"Muir Beach CDP, California",Muir Beach CDP,360,323,37
1600000US0650034,0650034,"Murphys CDP, California",Murphys CDP,1944,1446,498
1600000US0650076,0650076,"Murrieta city, California",Murrieta city,113480,77418,36062
1600000US0650132,0650132,"Muscoy CDP, California",Muscoy CDP,11194,6866,4328
1600000US0650146,0650146,"Myers Flat CDP, California",Myers Flat CDP,126,126,0
1600000US0650188,0650188,"Myrtletown CDP, California",Myrtletown CDP,4850,2073,2777
1600000US0650258,0650258,"Napa city, California",Napa city,77305,44209,33096
1600000US0650398,0650398,"National City city, California",National City city,55100,21441,33659
1600000US0650734,0650734,"Needles city, California",Needles city,4959,2901,2058
1600000US0650874,0650874,"Nevada City city, California",Nevada City city,2875,1123,1752
1600000US0650916,0650916,"Newark city, California",Newark city,48007,31692,16315
1600000US0651000,0651000,"Newcastle CDP, California",Newcastle CDP,1349,1286,63
1600000US0651028,0651028,"New Cuyama CDP, California",New Cuyama CDP,550,431,119
1600000US0651042,0651042,"Newell CDP, California",Newell CDP,481,348,133
1600000US0651140,0651140,"Newman city, California",Newman city,11434,8232,3202
1600000US0651168,0651168,"New Pine Creek CDP, California",New Pine Creek CDP,47,47,0
1600000US0651182,0651182,"Newport Beach city, California",Newport Beach city,86217,50962,35255
1600000US0651280,0651280,"Nicasio CDP, California",Nicasio CDP,123,121,2
1600000US0651294,0651294,"Nice CDP, California",Nice CDP,2384,1483,901
1600000US0651336,0651336,"Nicolaus CDP, California",Nicolaus CDP,124,73,51
1600000US0651392,0651392,"Niland CDP, California",Niland CDP,743,381,362
1600000US0651470,0651470,"Nipinnawasee CDP, California",Nipinnawasee CDP,388,312,76
1600000US0651476,0651476,"Nipomo CDP, California",Nipomo CDP,18163,12485,5678
1600000US0651560,0651560,"Norco city, California",Norco city,23945,19966,3979
1600000US0651574,0651574,"Nord CDP, California",Nord CDP,368,236,132
1600000US0651622,0651622,"Norris Canyon CDP, California",Norris Canyon CDP,790,773,17
1600000US0651637,0651637,"North Auburn CDP, California",North Auburn CDP,13555,8321,5234
1600000US0651812,0651812,"North Edwards CDP, California",North Edwards CDP,906,521,385
1600000US0651820,0651820,"North El Monte CDP, California",North El Monte CDP,3654,2415,1239
1600000US0651840,0651840,"North Fair Oaks CDP, California",North Fair Oaks CDP,14903,8309,6594
1600000US0651868,0651868,"North Fork CDP, California",North Fork CDP,3306,2471,835
1600000US0651890,0651890,"North Gate CDP, California",North Gate CDP,740,647,93
1600000US0651924,0651924,"North Highlands CDP, California",North Highlands CDP,48361,22495,25866
1600000US0651990,0651990,"North Lakeport CDP, California",North Lakeport CDP,3067,2050,1017
1600000US0652162,0652162,"North Richmond CDP, California",North Richmond CDP,4258,2780,1478
1600000US0652246,0652246,"North San Juan CDP, California",North San Juan CDP,151,94,57
1600000US0652302,0652302,"North Shore CDP, California",North Shore CDP,2580,2528,52
1600000US0652379,0652379,"North Tustin CDP, California",North Tustin CDP,24917,22349,2568
1600000US0652526,0652526,"Norwalk city, California",Norwalk city,101902,68868,33034
1600000US0652582,0652582,"Novato city, California",Novato city,53123,35970,17153
1600000US0652610,0652610,"Nubieber CDP, California",Nubieber CDP,31,25,6
1600000US0652624,0652624,"Nuevo CDP, California",Nuevo CDP,6999,4815,2184
1600000US0652694,0652694,"Oakdale city, California",Oakdale city,22709,15106,7603
1600000US0652715,0652715,"Oak Glen CDP, California",Oak Glen CDP,267,243,24
1600000US0652760,0652760,"Oak Hills CDP, California",Oak Hills CDP,10415,8806,1609
1600000US0652764,0652764,"Oakhurst CDP, California",Oakhurst CDP,5397,3613,1784
1600000US0653000,0653000,"Oakland city, California",Oakland city,415937,182929,233008
1600000US0653070,0653070,"Oakley city, California",Oakley city,41554,30822,10732
1600000US0653116,0653116,"Oak Park CDP, California",Oak Park CDP,13982,9796,4186
1600000US0653140,0653140,"Oak Run CDP, California",Oak Run CDP,371,355,16
1600000US0653160,0653160,"Oak Shores CDP, California",Oak Shores CDP,325,306,19
1600000US0653182,0653182,"Oak View CDP, California",Oak View CDP,6541,4874,1667
1600000US0653196,0653196,"Oakville CDP, California",Oakville CDP,74,0,74
1600000US0653224,0653224,"Oasis CDP, California",Oasis CDP,2549,1774,775
1600000US0653266,0653266,"Occidental CDP, California",Occidental CDP,876,625,251
1600000US0653294,0653294,"Oceano CDP, California",Oceano CDP,7601,4537,3064
1600000US0653322,0653322,"Oceanside city, California",Oceanside city,174939,99323,75616
1600000US0653378,0653378,"Ocotillo CDP, California",Ocotillo CDP,44,18,26
1600000US0653448,0653448,"Oildale CDP, California",Oildale CDP,35501,11169,24332
1600000US0653476,0653476,"Ojai city, California",Ojai city,7362,4547,2815
1600000US0653490,0653490,"Olancha CDP, California",Olancha CDP,181,181,0
1600000US0653503,0653503,"Olde Stockdale CDP, California",Olde Stockdale CDP,839,784,55
1600000US0653505,0653505,"Old Fig Garden CDP, California",Old Fig Garden CDP,5594,4727,867
1600000US0653574,0653574,"Old River CDP, California",Old River CDP,76,76,0
1600000US0653602,0653602,"Old Station CDP, California",Old Station CDP,21,21,0
1600000US0653603,0653603,"Old Stine CDP, California",Old Stine CDP,3381,2094,1287
1600000US0653714,0653714,"Olivehurst CDP, California",Olivehurst CDP,15076,10328,4748
1600000US0653882,0653882,"Ono CDP, California",Ono CDP,57,57,0
1600000US0653896,0653896,"Ontario city, California",Ontario city,177433,97432,80001
1600000US0653910,0653910,"Onyx CDP, California",Onyx CDP,576,471,105
1600000US0653980,0653980,"Orange city, California",Orange city,131820,77242,54578
1600000US0653987,0653987,"Orange Blossom CDP, California",Orange Blossom CDP,1155,699,456
1600000US0654008,0654008,"Orange Cove city, California",Orange Cove city,10120,4151,5969
1600000US0654092,0654092,"Orangevale CDP, California",Orangevale CDP,34755,25863,8892
1600000US0654120,0654120,"Orcutt CDP, California",Orcutt CDP,31199,23616,7583
1600000US0654218,0654218,"Orick CDP, California",Orick CDP,346,123,223
1600000US0654232,0654232,"Orinda city, California",Orinda city,19415,18212,1203
1600000US0654274,0654274,"Orland city, California",Orland city,7833,4138,3695
1600000US0654372,0654372,"Orosi CDP, California",Orosi CDP,8908,5039,3869
1600000US0654386,0654386,"Oroville city, California",Oroville city,17978,8381,9597
1600000US0654388,0654388,"Oroville East CDP, California",Oroville East CDP,8078,6803,1275
1600000US0654652,0654652,"Oxnard city, California",Oxnard city,206207,109507,96700
1600000US0654764,0654764,"Pacheco CDP, California",Pacheco CDP,4775,3550,1225
1600000US0654806,0654806,"Pacifica city, California",Pacifica city,38476,27899,10577
1600000US0654848,0654848,"Pacific Grove city, California",Pacific Grove city,15217,7273,7944
1600000US0655044,0655044,"Pajaro CDP, California",Pajaro CDP,3402,677,2725
1600000US0655048,0655048,"Pajaro Dunes CDP, California",Pajaro Dunes CDP,235,93,142
1600000US0655058,0655058,"Pala CDP, California",Pala CDP,1094,678,416
1600000US0655086,0655086,"Palermo CDP, California",Palermo CDP,5204,3702,1502
1600000US0655156,0655156,"Palmdale city, California",Palmdale city,153009,98650,54359
1600000US0655184,0655184,"Palm Desert city, California",Palm Desert city,52797,33365,19432
1600000US0655254,0655254,"Palm Springs city, California",Palm Springs city,47888,28951,18937
1600000US0655282,0655282,"Palo Alto city, California",Palo Alto city,67430,40129,27301
1600000US0655296,0655296,"Palo Cedro CDP, California",Palo Cedro CDP,2868,2718,150
1600000US0655380,0655380,"Palos Verdes Estates city, California",Palos Verdes Estates city,13329,11767,1562
1600000US0655422,0655422,"Palo Verde CDP, California",Palo Verde CDP,78,20,58
1600000US0655506,0655506,"Panorama Heights CDP, California",Panorama Heights CDP,51,45,6
1600000US0655520,0655520,"Paradise town, California",Paradise town,17136,11865,5271
1600000US0655528,0655528,"Paradise CDP, California",Paradise CDP,168,135,33
1600000US0655604,0655604,"Paradise Park CDP, California",Paradise Park CDP,468,458,10
1600000US0655618,0655618,"Paramount city, California",Paramount city,53638,23093,30545
1600000US0655728,0655728,"Parklawn CDP, California",Parklawn CDP,1844,1176,668
1600000US0655751,0655751,"Parksdale CDP, California",Parksdale CDP,2725,1470,1255
1600000US0655800,0655800,"Parkway CDP, California",Parkway CDP,16203,7324,8879
1600000US0655842,0655842,"Parkwood CDP, California",Parkwood CDP,2394,1642,752
1600000US0655856,0655856,"Parlier city, California",Parlier city,15645,7039,8606
1600000US0656000,0656000,"Pasadena city, California",Pasadena city,138146,60139,78007
1600000US0656028,0656028,"Pasatiempo CDP, California",Pasatiempo CDP,1226,1040,186
1600000US0656042,0656042,"Paskenta CDP, California",Paskenta CDP,50,27,23
1600000US0656112,0656112,"Patterson city, California",Patterson city,22281,16347,5934
1600000US0656120,0656120,"Patterson Tract CDP, California",Patterson Tract CDP,2003,1532,471
1600000US0656140,0656140,"Patton Village CDP, California",Patton Village CDP,635,375,260
1600000US0656182,0656182,"Paxton CDP, California",Paxton CDP,0,0,0
1600000US0656196,0656196,"Paynes Creek CDP, California",Paynes Creek CDP,47,47,0
1600000US0656294,0656294,"Pearsonville CDP, California",Pearsonville CDP,0,0,0
1600000US0656476,0656476,"Penngrove CDP, California",Penngrove CDP,2368,1738,630
1600000US0656518,0656518,"Penn Valley CDP, California",Penn Valley CDP,1059,780,279
1600000US0656546,0656546,"Penryn CDP, California",Penryn CDP,878,775,103
1600000US0656598,0656598,"Pepperdine University CDP, California",Pepperdine University CDP,355,292,63
1600000US0656700,0656700,"Perris city, California",Perris city,77411,51966,25445
1600000US0656756,0656756,"Pescadero CDP, California",Pescadero CDP,418,107,311
1600000US0656784,0656784,"Petaluma city, California",Petaluma city,60193,39287,20906
1600000US0656786,0656786,"Petaluma Center CDP, California",Petaluma Center CDP,740,0,740
1600000US0656798,0656798,"Peters CDP, California",Peters CDP,472,456,16
1600000US0656826,0656826,"Phelan CDP, California",Phelan CDP,18979,14407,4572
1600000US0656854,0656854,"Phillipsville CDP, California",Phillipsville CDP,102,29,73
1600000US0656868,0656868,"Philo CDP, California",Philo CDP,149,18,131
1600000US0656870,0656870,"Phoenix Lake CDP, California",Phoenix Lake CDP,4820,3847,973
1600000US0656924,0656924,"Pico Rivera city, California",Pico Rivera city,62055,45317,16738
1600000US0656938,0656938,"Piedmont city, California",Piedmont city,11449,9980,1469
1600000US0657011,0657011,"Pierpoint CDP, California",Pierpoint CDP,42,42,0
1600000US0657036,0657036,"Pike CDP, California",Pike CDP,120,48,72
1600000US0657070,0657070,"Pine Canyon CDP, California",Pine Canyon CDP,2934,2594,340
1600000US0657134,0657134,"Pine Flat CDP, California",Pine Flat CDP,153,118,35
1600000US0657148,0657148,"Pine Grove CDP, California",Pine Grove CDP,2070,1633,437
1600000US0657204,0657204,"Pine Hills CDP, California",Pine Hills CDP,3524,2833,691
1600000US0657240,0657240,"Pine Mountain Club CDP, California",Pine Mountain Club CDP,2011,1721,290
1600000US0657244,0657244,"Pine Mountain Lake CDP, California",Pine Mountain Lake CDP,2790,2461,329
1600000US0657260,0657260,"Pine Valley CDP, California",Pine Valley CDP,1611,1271,340
1600000US0657288,0657288,"Pinole city, California",Pinole city,19252,13722,5530
1600000US0657302,0657302,"Piñon Hills CDP, California",Piñon Hills CDP,6937,5196,1741
1600000US0657330,0657330,"Pioneer CDP, California",Pioneer CDP,1224,1020,204
1600000US0657372,0657372,"Piru CDP, California",Piru CDP,2126,1156,970
1600000US0657414,0657414,"Pismo Beach city, California",Pismo Beach city,8037,6241,1796
1600000US0657456,0657456,"Pittsburg city, California",Pittsburg city,71354,42349,29005
1600000US0657512,0657512,"Pixley CDP, California",Pixley CDP,4322,2266,2056
1600000US0657526,0657526,"Placentia city, California",Placentia city,51525,33183,18342
1600000US0657540,0657540,"Placerville city, California",Placerville city,10287,6486,3801
1600000US0657568,0657568,"Plainview CDP, California",Plainview CDP,610,290,320
1600000US0657582,0657582,"Planada CDP, California",Planada CDP,3984,2245,1739
1600000US0657666,0657666,"Platina CDP, California",Platina CDP,23,0,23
1600000US0657764,0657764,"Pleasant Hill city, California",Pleasant Hill city,34500,23973,10527
1600000US0657792,0657792,"Pleasanton city, California",Pleasanton city,79673,57085,22588
1600000US0657825,0657825,"Pleasure Point CDP, California",Pleasure Point CDP,6173,3931,2242
1600000US0657828,0657828,"Plumas Eureka CDP, California",Plumas Eureka CDP,358,281,77
1600000US0657829,0657829,"Plumas Lake CDP, California",Plumas Lake CDP,7665,6174,1491
1600000US0657834,0657834,"Plymouth city, California",Plymouth city,1031,701,330
1600000US0657876,0657876,"Point Arena city, California",Point Arena city,407,187,220
1600000US0657960,0657960,"Point Reyes Station CDP, California",Point Reyes Station CDP,210,150,60
1600000US0658030,0658030,"Pollock Pines CDP, California",Pollock Pines CDP,6456,4853,1603
1600000US0658072,0658072,"Pomona city, California",Pomona city,146819,78558,68261
1600000US0658134,0658134,"Ponderosa CDP, California",Ponderosa CDP,52,52,0
1600000US0658191,0658191,"Poplar-Cotton Center CDP, California",Poplar-Cotton Center CDP,1840,737,1103
1600000US0658226,0658226,"Port Costa CDP, California",Port Costa CDP,242,60,182
1600000US0658240,0658240,"Porterville city, California",Porterville city,57698,29257,28441
1600000US0658296,0658296,"Port Hueneme city, California",Port Hueneme city,20952,10450,10502
1600000US0658352,0658352,"Portola city, California",Portola city,1717,952,765
1600000US0658380,0658380,"Portola Valley town, California",Portola Valley town,4524,3733,791
1600000US0658422,0658422,"Posey CDP, California",Posey CDP,0,0,0
1600000US0658436,0658436,"Poso Park CDP, California",Poso Park CDP,3,3,0
1600000US0658456,0658456,"Post Mountain CDP, California",Post Mountain CDP,82,47,35
1600000US0658471,0658471,"Potomac Park CDP, California",Potomac Park CDP,10833,3522,7311
1600000US0658478,0658478,"Potrero CDP, California",Potrero CDP,250,148,102
1600000US0658506,0658506,"Potter Valley CDP, California",Potter Valley CDP,351,249,102
1600000US0658520,0658520,"Poway city, California",Poway city,49153,39212,9941
1600000US0658618,0658618,"Prattville CDP, California",Prattville CDP,27,27,0
1600000US0658758,0658758,"Princeton CDP, California",Princeton CDP,337,169,168
1600000US0658814,0658814,"Proberta CDP, California",Proberta CDP,36,36,0
1600000US0658870,0658870,"Prunedale CDP, California",Prunedale CDP,20533,15612,4921
1600000US0658940,0658940,"Pumpkin Center CDP, California",Pumpkin Center CDP,169,35,134
1600000US0659052,0659052,"Quartz Hill CDP, California",Quartz Hill CDP,10374,7097,3277
1600000US0659080,0659080,"Quincy CDP, California",Quincy CDP,1653,849,804
1600000US0659115,0659115,"Rackerby CDP, California",Rackerby CDP,193,98,95
1600000US0659220,0659220,"Rail Road Flat CDP, California",Rail Road Flat CDP,97,67,30
1600000US0659248,0659248,"Rainbow CDP, California",Rainbow CDP,2117,1653,464
1600000US0659290,0659290,"Raisin City CDP, California",Raisin City CDP,377,165,212
1600000US0659346,0659346,"Ramona CDP, California",Ramona CDP,21362,13218,8144
1600000US0659426,0659426,"Rancho Calaveras CDP, California",Rancho Calaveras CDP,6296,5121,1175
1600000US0659444,0659444,"Rancho Cordova city, California",Rancho Cordova city,73862,41686,32176
1600000US0659451,0659451,"Rancho Cucamonga city, California",Rancho Cucamonga city,174978,112129,62849
1600000US0659500,0659500,"Rancho Mirage city, California",Rancho Mirage city,18423,14293,4130
1600000US0659503,0659503,"Rancho Mission Viejo CDP, California",Rancho Mission Viejo CDP,7816,6427,1389
1600000US0659506,0659506,"Rancho Murieta CDP, California",Rancho Murieta CDP,5682,5249,433
1600000US0659514,0659514,"Rancho Palos Verdes city, California",Rancho Palos Verdes city,41143,30513,10630
1600000US0659550,0659550,"Rancho San Diego CDP, California",Rancho San Diego CDP,21417,15682,5735
1600000US0659584,0659584,"Rancho Santa Fe CDP, California",Rancho Santa Fe CDP,2657,2064,593
1600000US0659587,0659587,"Rancho Santa Margarita city, California",Rancho Santa Margarita city,48280,36236,12044
1600000US0659604,0659604,"Rancho Tehama Reserve CDP, California",Rancho Tehama Reserve CDP,1750,1134,616
1600000US0659668,0659668,"Randsburg CDP, California",Randsburg CDP,99,99,0
1600000US0659892,0659892,"Red Bluff city, California",Red Bluff city,13634,5762,7872
1600000US0659896,0659896,"Red Corral CDP, California",Red Corral CDP,1463,1127,336
1600000US0659906,0659906,"Redcrest CDP, California",Redcrest CDP,19,19,0
1600000US0659920,0659920,"Redding city, California",Redding city,89554,49906,39648
1600000US0659962,0659962,"Redlands city, California",Redlands city,68898,40964,27934
1600000US0660018,0660018,"Redondo Beach city, California",Redondo Beach city,66498,37676,28822
1600000US0660088,0660088,"Redway CDP, California",Redway CDP,1315,1194,121
1600000US0660102,0660102,"Redwood City city, California",Redwood City city,82982,39158,43824
1600000US0660214,0660214,"Redwood Valley CDP, California",Redwood Valley CDP,1812,1151,661
1600000US0660242,0660242,"Reedley city, California",Reedley city,25376,14355,11021
1600000US0660279,0660279,"Reliez Valley CDP, California",Reliez Valley CDP,3278,2946,332
1600000US0660370,0660370,"Rexland Acres CDP, California",Rexland Acres CDP,3463,1824,1639
1600000US0660466,0660466,"Rialto city, California",Rialto city,102995,66102,36893
1600000US0660592,0660592,"Richfield CDP, California",Richfield CDP,341,199,142
1600000US0660606,0660606,"Richgrove CDP, California",Richgrove CDP,2098,1226,872
1600000US0660620,0660620,"Richmond city, California",Richmond city,108691,57322,51369
1600000US0660662,0660662,"Richvale CDP, California",Richvale CDP,157,157,0
1600000US0660704,0660704,"Ridgecrest city, California",Ridgecrest city,28706,18011,10695
1600000US0660705,0660705,"Ridgecrest Heights CDP, California",Ridgecrest Heights CDP,193,94,99
1600000US0660706,0660706,"Ridgemark CDP, California",Ridgemark CDP,2549,1978,571
1600000US0660900,0660900,"Rio Dell city, California",Rio Dell city,3358,2138,1220
1600000US0660928,0660928,"Rio del Mar CDP, California",Rio del Mar CDP,9704,7291,2413
1600000US0660942,0660942,"Rio Linda CDP, California",Rio Linda CDP,16032,11266,4766
1600000US0660970,0660970,"Rio Oso CDP, California",Rio Oso CDP,414,359,55
1600000US0660984,0660984,"Rio Vista city, California",Rio Vista city,9402,7623,1779
1600000US0661012,0661012,"Ripley CDP, California",Ripley CDP,460,206,254
1600000US0661026,0661026,"Ripon city, California",Ripon city,15970,11191,4779
1600000US0661068,0661068,"Riverbank city, California",Riverbank city,24419,16683,7736
1600000US0661096,0661096,"Riverdale CDP, California",Riverdale CDP,2727,1476,1251
1600000US0661106,0661106,"Riverdale Park CDP, California",Riverdale Park CDP,1393,187,1206
1600000US0661108,0661108,"Rivergrove CDP, California",Rivergrove CDP,51,36,15
1600000US0661124,0661124,"River Pines CDP, California",River Pines CDP,420,365,55
1600000US0662000,0662000,"Riverside city, California",Riverside city,311669,177636,134033
1600000US0662168,0662168,"Robbins CDP, California",Robbins CDP,428,239,189
1600000US0662200,0662200,"Robinson Mill CDP, California",Robinson Mill CDP,48,29,19
1600000US0662364,0662364,"Rocklin city, California",Rocklin city,66098,46460,19638
1600000US0662490,0662490,"Rodeo CDP, California",Rodeo CDP,9980,6182,3798
1600000US0662496,0662496,"Rodriguez Camp CDP, California",Rodriguez Camp CDP,61,0,61
1600000US0662546,0662546,"Rohnert Park city, California",Rohnert Park city,42496,22334,20162
1600000US0662602,0662602,"Rolling Hills city, California",Rolling Hills city,1439,1369,70
1600000US0662625,0662625,"Rolling Hills CDP, California",Rolling Hills CDP,706,706,0
1600000US0662644,0662644,"Rolling Hills Estates city, California",Rolling Hills Estates city,8025,7483,542
1600000US0662700,0662700,"Rollingwood CDP, California",Rollingwood CDP,3598,2086,1512
1600000US0662756,0662756,"Romoland CDP, California",Romoland CDP,2755,2364,391
1600000US0662826,0662826,"Rosamond CDP, California",Rosamond CDP,20248,14161,6087
1600000US0662854,0662854,"Rosedale CDP, California",Rosedale CDP,18989,15529,3460
1600000US0662860,0662860,"Rose Hills CDP, California",Rose Hills CDP,2619,2510,109
1600000US0662896,0662896,"Rosemead city, California",Rosemead city,53279,25914,27365
1600000US0662910,0662910,"Rosemont CDP, California",Rosemont CDP,23509,12657,10852
1600000US0662938,0662938,"Roseville city, California",Roseville city,137863,97443,40420
1600000US0662980,0662980,"Ross town, California",Ross town,2385,1892,493
1600000US0663050,0663050,"Rossmoor CDP, California",Rossmoor CDP,11916,10068,1848
1600000US0663106,0663106,"Rough and Ready CDP, California",Rough and Ready CDP,511,260,251
1600000US0663134,0663134,"Round Mountain CDP, California",Round Mountain CDP,100,78,22
1600000US0663148,0663148,"Round Valley CDP, California",Round Valley CDP,325,96,229
1600000US0663168,0663168,"Rouse CDP, California",Rouse CDP,1684,735,949
1600000US0663218,0663218,"Rowland Heights CDP, California",Rowland Heights CDP,49732,32907,16825
1600000US0663302,0663302,"Rumsey CDP, California",Rumsey CDP,107,100,7
1600000US0663316,0663316,"Running Springs CDP, California",Running Springs CDP,4410,3045,1365
1600000US0663386,0663386,"Ruth CDP, California",Ruth CDP,213,187,26
1600000US0663400,0663400,"Rutherford CDP, California",Rutherford CDP,100,20,80
1600000US0664000,0664000,"Sacramento city, California",Sacramento city,494338,258677,235661
1600000US0664056,0664056,"Sage CDP, California",Sage CDP,2792,2510,282
1600000US0664140,0664140,"St. Helena city, California",St. Helena city,5971,3884,2087
1600000US0664210,0664210,"Salida CDP, California",Salida CDP,15235,10676,4559
1600000US0664224,0664224,"Salinas city, California",Salinas city,154634,70224,84410
1600000US0664252,0664252,"Salmon Creek CDP, California",Salmon Creek CDP,20,20,0
1600000US0664294,0664294,"Salton City CDP, California",Salton City CDP,5975,4287,1688
1600000US0664308,0664308,"Salton Sea Beach CDP, California",Salton Sea Beach CDP,295,211,84
1600000US0664378,0664378,"Salyer CDP, California",Salyer CDP,403,175,228
1600000US0664392,0664392,"Samoa CDP, California",Samoa CDP,211,0,211
1600000US0664420,0664420,"San Andreas CDP, California",San Andreas CDP,3553,1559,1994
1600000US0664434,0664434,"San Anselmo town, California",San Anselmo town,12542,9220,3322
1600000US0664462,0664462,"San Antonio Heights CDP, California",San Antonio Heights CDP,3091,2540,551
1600000US0664476,0664476,"San Ardo CDP, California",San Ardo CDP,628,176,452
1600000US0665000,0665000,"San Bernardino city, California",San Bernardino city,205996,103428,102568
1600000US0665028,0665028,"San Bruno city, California",San Bruno city,44194,28101,16093
1600000US0665042,0665042,"San Buenaventura (Ventura) city, California",San Buenaventura (Ventura) city,106503,60852,45651
1600000US0665070,0665070,"San Carlos city, California",San Carlos city,29520,21819,7701
1600000US0665084,0665084,"San Clemente city, California",San Clemente city,64596,44168,20428
1600000US0665112,0665112,"Sand City city, California",Sand City city,320,43,277
1600000US0666000,0666000,"San Diego city, California",San Diego city,1376865,682559,694306
1600000US0666004,0666004,"San Diego Country Estates CDP, California",San Diego Country Estates CDP,9734,7941,1793
1600000US0666070,0666070,"San Dimas city, California",San Dimas city,33013,23670,9343
1600000US0666140,0666140,"San Fernando city, California",San Fernando city,24133,13942,10191
1600000US0667000,0667000,"San Francisco city, California",San Francisco city,854615,374451,480164
1600000US0667042,0667042,"San Gabriel city, California",San Gabriel city,39422,19180,20242
1600000US0667056,0667056,"Sanger city, California",Sanger city,26576,16136,10440
1600000US0667070,0667070,"San Geronimo CDP, California",San Geronimo CDP,176,160,16
1600000US0667112,0667112,"San Jacinto city, California",San Jacinto city,48587,31254,17333
1600000US0667126,0667126,"San Joaquin city, California",San Joaquin city,4025,1874,2151
1600000US0668000,0668000,"San Jose city, California",San Jose city,1015442,585819,429623
1600000US0668014,0668014,"San Juan Bautista city, California",San Juan Bautista city,2086,835,1251
1600000US0668028,0668028,"San Juan Capistrano city, California",San Juan Capistrano city,35830,25511,10319
1600000US0668084,0668084,"San Leandro city, California",San Leandro city,90007,51940,38067
1600000US0668112,0668112,"San Lorenzo CDP, California",San Lorenzo CDP,29863,19634,10229
1600000US0668140,0668140,"San Lucas CDP, California",San Lucas CDP,415,189,226
1600000US0668154,0668154,"San Luis Obispo city, California",San Luis Obispo city,45965,18146,27819
1600000US0668196,0668196,"San Marcos city, California",San Marcos city,95259,58370,36889
1600000US0668224,0668224,"San Marino city, California",San Marino city,12909,10118,2791
1600000US0668238,0668238,"San Martin CDP, California",San Martin CDP,6278,4540,1738
1600000US0668252,0668252,"San Mateo city, California",San Mateo city,102085,54284,47801
1600000US0668263,0668263,"San Miguel CDP (Contra Costa County), California",San Miguel CDP (Contra Costa County),3245,3086,159
1600000US0668266,0668266,"San Miguel CDP (San Luis Obispo County), California",San Miguel CDP (San Luis Obispo County),2518,1212,1306
1600000US0668294,0668294,"San Pablo city, California",San Pablo city,30515,12409,18106
1600000US0668308,0668308,"San Pasqual CDP, California",San Pasqual CDP,2038,1109,929
1600000US0668364,0668364,"San Rafael city, California",San Rafael city,57082,27203,29879
1600000US0668378,0668378,"San Ramon city, California",San Ramon city,81237,62328,18909
1600000US0668434,0668434,"San Simeon CDP, California",San Simeon CDP,534,111,423
1600000US0669000,0669000,"Santa Ana city, California",Santa Ana city,328060,151212,176848
1600000US0669070,0669070,"Santa Barbara city, California",Santa Barbara city,89527,36602,52925
1600000US0669084,0669084,"Santa Clara city, California",Santa Clara city,121499,55227,66272
1600000US0669088,0669088,"Santa Clarita city, California",Santa Clarita city,210549,147703,62846
1600000US0669112,0669112,"Santa Cruz city, California",Santa Cruz city,54657,26527,28130
1600000US0669154,0669154,"Santa Fe Springs city, California",Santa Fe Springs city,17449,11768,5681
1600000US0669182,0669182,"Santa Margarita CDP, California",Santa Margarita CDP,1025,565,460
1600000US0669196,0669196,"Santa Maria city, California",Santa Maria city,104436,48851,55585
1600000US0670000,0670000,"Santa Monica city, California",Santa Monica city,89974,30125,59849
1600000US0670028,0670028,"Santa Nella CDP, California",Santa Nella CDP,1981,1357,624
1600000US0670042,0670042,"Santa Paula city, California",Santa Paula city,30161,15180,14981
1600000US0670098,0670098,"Santa Rosa city, California",Santa Rosa city,175133,95309,79824
1600000US0670130,0670130,"Santa Rosa Valley CDP, California",Santa Rosa Valley CDP,2721,2660,61
1600000US0670140,0670140,"Santa Susana CDP, California",Santa Susana CDP,918,755,163
1600000US0670154,0670154,"Santa Venetia CDP, California",Santa Venetia CDP,3648,2854,794
1600000US0670182,0670182,"Santa Ynez CDP, California",Santa Ynez CDP,4724,3351,1373
1600000US0670224,0670224,"Santee city, California",Santee city,55446,39014,16432
1600000US0670266,0670266,"Saranap CDP, California",Saranap CDP,5991,4201,1790
1600000US0670280,0670280,"Saratoga city, California",Saratoga city,30869,26612,4257
1600000US0670322,0670322,"Saticoy CDP, California",Saticoy CDP,1739,690,1049
1600000US0670336,0670336,"Sattley CDP, California",Sattley CDP,73,73,0
1600000US0670364,0670364,"Sausalito city, California",Sausalito city,7155,4143,3012
1600000US0670518,0670518,"Scotia CDP, California",Scotia CDP,490,21,469
1600000US0670588,0670588,"Scotts Valley city, California",Scotts Valley city,11851,9172,2679
1600000US0670644,0670644,"Seacliff CDP, California",Seacliff CDP,3580,2347,1233
1600000US0670686,0670686,"Seal Beach city, California",Seal Beach city,24029,18013,6016
1600000US0670712,0670712,"Sea Ranch CDP, California",Sea Ranch CDP,1156,914,242
1600000US0670728,0670728,"Searles Valley CDP, California",Searles Valley CDP,1647,741,906
1600000US0670742,0670742,"Seaside city, California",Seaside city,32777,11971,20806
1600000US0670770,0670770,"Sebastopol city, California",Sebastopol city,7546,4197,3349
1600000US0670798,0670798,"Seeley CDP, California",Seeley CDP,1847,1139,708
1600000US0670882,0670882,"Selma city, California",Selma city,24271,12144,12127
1600000US0670966,0670966,"Sequoia Crest CDP, California",Sequoia Crest CDP,39,39,0
1600000US0671000,0671000,"Sereno del Mar CDP, California",Sereno del Mar CDP,57,11,46
1600000US0671078,0671078,"Seville CDP, California",Seville CDP,449,243,206
1600000US0671106,0671106,"Shafter city, California",Shafter city,18931,10494,8437
1600000US0671134,0671134,"Shandon CDP, California",Shandon CDP,1054,812,242
1600000US0671218,0671218,"Shasta CDP, California",Shasta CDP,1639,1390,249
1600000US0671225,0671225,"Shasta Lake city, California",Shasta Lake city,10206,6576,3630
1600000US0671246,0671246,"Shaver Lake CDP, California",Shaver Lake CDP,438,414,24
1600000US0671362,0671362,"Shell Ridge CDP, California",Shell Ridge CDP,1081,970,111
1600000US0671372,0671372,"Shelter Cove CDP, California",Shelter Cove CDP,863,608,255
1600000US0671414,0671414,"Sheridan CDP, California",Sheridan CDP,1120,612,508
1600000US0671554,0671554,"Shingle Springs CDP, California",Shingle Springs CDP,3651,2555,1096
1600000US0671568,0671568,"Shingletown CDP, California",Shingletown CDP,2291,2086,205
1600000US0671680,0671680,"Shoshone CDP, California",Shoshone CDP,18,0,18
1600000US0671774,0671774,"Sierra Brooks CDP, California",Sierra Brooks CDP,441,441,0
1600000US0671778,0671778,"Sierra City CDP, California",Sierra City CDP,84,84,0
1600000US0671806,0671806,"Sierra Madre city, California",Sierra Madre city,10824,7080,3744
1600000US0671834,0671834,"Sierra Village CDP, California",Sierra Village CDP,226,32,194
1600000US0671848,0671848,"Sierraville CDP, California",Sierraville CDP,161,62,99
1600000US0671876,0671876,"Signal Hill city, California",Signal Hill city,11374,4799,6575
1600000US0671918,0671918,"Silverado CDP, California",Silverado CDP,740,646,94
1600000US0671927,0671927,"Silverado Resort CDP, California",Silverado Resort CDP,1171,1034,137
1600000US0671932,0671932,"Silver City CDP, California",Silver City CDP,0,0,0
1600000US0671964,0671964,"Silver Lakes CDP, California",Silver Lakes CDP,6050,4883,1167
1600000US0672016,0672016,"Simi Valley city, California",Simi Valley city,125000,91811,33189
1600000US0672086,0672086,"Sisquoc CDP, California",Sisquoc CDP,169,106,63
1600000US0672156,0672156,"Sky Valley CDP, California",Sky Valley CDP,2245,1834,411
1600000US0672184,0672184,"Sleepy Hollow CDP, California",Sleepy Hollow CDP,2230,2004,226
1600000US0672282,0672282,"Smartsville CDP, California",Smartsville CDP,485,379,106
1600000US0672338,0672338,"Smith Corner CDP, California",Smith Corner CDP,413,40,373
1600000US0672380,0672380,"Smith River CDP, California",Smith River CDP,670,609,61
1600000US0672408,0672408,"Snelling CDP, California",Snelling CDP,115,86,29
1600000US0672478,0672478,"Soda Bay CDP, California",Soda Bay CDP,708,639,69
1600000US0672492,0672492,"Soda Springs CDP, California",Soda Springs CDP,46,46,0
1600000US0672506,0672506,"Solana Beach city, California",Solana Beach city,13301,8464,4837
1600000US0672520,0672520,"Soledad city, California",Soledad city,17070,10007,7063
1600000US0672576,0672576,"Solvang city, California",Solvang city,5586,3553,2033
1600000US0672632,0672632,"Somis CDP, California",Somis CDP,1189,1008,181
1600000US0672646,0672646,"Sonoma city, California",Sonoma city,10856,6852,4004
1600000US0672654,0672654,"Sonoma State University CDP, California",Sonoma State University CDP,0,0,0
1600000US0672674,0672674,"Sonora city, California",Sonora city,4570,2845,1725
1600000US0672688,0672688,"Soquel CDP, California",Soquel CDP,10641,7162,3479
1600000US0672772,0672772,"Soulsbyville CDP, California",Soulsbyville CDP,2063,1820,243
1600000US0672954,0672954,"South Dos Palos CDP, California",South Dos Palos CDP,1167,543,624
1600000US0672996,0672996,"South El Monte city, California",South El Monte city,20744,10325,10419
1600000US0673080,0673080,"South Gate city, California",South Gate city,94837,45981,48856
1600000US0673108,0673108,"South Lake Tahoe city, California",South Lake Tahoe city,22222,8973,13249
1600000US0673167,0673167,"South Monrovia Island CDP, California",South Monrovia Island CDP,6423,4001,2422
1600000US0673178,0673178,"South Oroville CDP, California",South Oroville CDP,2494,1349,1145
1600000US0673220,0673220,"South Pasadena city, California",South Pasadena city,25362,13724,11638
1600000US0673262,0673262,"South San Francisco city, California",South San Francisco city,66101,41067,25034
1600000US0673276,0673276,"South San Gabriel CDP, California",South San Gabriel CDP,8200,5599,2601
1600000US0673290,0673290,"South San Jose Hills CDP, California",South San Jose Hills CDP,19056,13881,5175
1600000US0673388,0673388,"South Taft CDP, California",South Taft CDP,2120,947,1173
1600000US0673430,0673430,"South Whittier CDP, California",South Whittier CDP,58265,37058,21207
1600000US0673554,0673554,"Spaulding CDP, California",Spaulding CDP,129,120,9
1600000US0673612,0673612,"Spreckels CDP, California",Spreckels CDP,373,250,123
1600000US0673654,0673654,"Spring Garden CDP, California",Spring Garden CDP,19,0,19
1600000US0673690,0673690,"Spring Valley CDP (Lake County), California",Spring Valley CDP (Lake County),1056,590,466
1600000US0673696,0673696,"Spring Valley CDP (San Diego County), California",Spring Valley CDP (San Diego County),31718,19330,12388
1600000US0673700,0673700,"Spring Valley Lake CDP, California",Spring Valley Lake CDP,8408,5918,2490
1600000US0673710,0673710,"Springville CDP, California",Springville CDP,567,305,262
1600000US0673794,0673794,"Squaw Valley CDP, California",Squaw Valley CDP,3506,2683,823
1600000US0673815,0673815,"Squirrel Mountain Valley CDP, California",Squirrel Mountain Valley CDP,1146,969,177
1600000US0673868,0673868,"Stallion Springs CDP, California",Stallion Springs CDP,2996,2326,670
1600000US0673906,0673906,"Stanford CDP, California",Stanford CDP,7253,2540,4713
1600000US0673962,0673962,"Stanton city, California",Stanton city,38090,17577,20513
1600000US0674021,0674021,"Stebbins CDP, California",Stebbins CDP,963,732,231
1600000US0674130,0674130,"Stevenson Ranch CDP, California",Stevenson Ranch CDP,18980,13596,5384
1600000US0674144,0674144,"Stevinson CDP, California",Stevinson CDP,196,190,6
1600000US0674172,0674172,"Stinson Beach CDP, California",Stinson Beach CDP,583,333,250
1600000US0674186,0674186,"Stirling City CDP, California",Stirling City CDP,300,29,271
1600000US0675000,0675000,"Stockton city, California",Stockton city,304537,153508,151029
1600000US0675122,0675122,"Stones Landing CDP, California",Stones Landing CDP,102,102,0
1600000US0675154,0675154,"Stonyford CDP, California",Stonyford CDP,71,55,16
1600000US0675252,0675252,"Stratford CDP, California",Stratford CDP,771,354,417
1600000US0675280,0675280,"Strathmore CDP, California",Strathmore CDP,3641,1957,1684
1600000US0675315,0675315,"Strawberry CDP (Marin County), California",Strawberry CDP (Marin County),4986,2276,2710
1600000US0675322,0675322,"Strawberry CDP (Tuolumne County), California",Strawberry CDP (Tuolumne County),0,0,0
1600000US0675592,0675592,"Sugarloaf Saw Mill CDP, California",Sugarloaf Saw Mill CDP,0,0,0
1600000US0675596,0675596,"Sugarloaf Village CDP, California",Sugarloaf Village CDP,8,8,0
1600000US0675630,0675630,"Suisun City city, California",Suisun City city,29331,18244,11087
1600000US0675672,0675672,"Sultana CDP, California",Sultana CDP,1336,301,1035
1600000US0675714,0675714,"Summerland CDP, California",Summerland CDP,745,544,201
1600000US0675994,0675994,"Sunnyside CDP, California",Sunnyside CDP,4551,3492,1059
1600000US0676015,0676015,"Sunnyside-Tahoe City CDP, California",Sunnyside-Tahoe City CDP,1572,1416,156
1600000US0676040,0676040,"Sunny Slopes CDP, California",Sunny Slopes CDP,68,68,0
1600000US0677000,0677000,"Sunnyvale city, California",Sunnyvale city,151594,71993,79601
1600000US0677042,0677042,"Sunol CDP, California",Sunol CDP,835,706,129
1600000US0677308,0677308,"Sun Village CDP, California",Sun Village CDP,14080,8849,5231
1600000US0677364,0677364,"Susanville city, California",Susanville city,6371,2983,3388
1600000US0677378,0677378,"Sutter CDP, California",Sutter CDP,2789,2253,536
1600000US0677392,0677392,"Sutter Creek city, California",Sutter Creek city,2625,1481,1144
1600000US0677430,0677430,"Swall Meadows CDP, California",Swall Meadows CDP,390,390,0
1600000US0677574,0677574,"Taft city, California",Taft city,8341,4428,3913
1600000US0677588,0677588,"Taft Heights CDP, California",Taft Heights CDP,1509,538,971
1600000US0677595,0677595,"Taft Mosswood CDP, California",Taft Mosswood CDP,1060,543,517
1600000US0677700,0677700,"Tahoe Vista CDP, California",Tahoe Vista CDP,1233,927,306
1600000US0677728,0677728,"Tahoma CDP, California",Tahoma CDP,1039,599,440
1600000US0677784,0677784,"Talmage CDP, California",Talmage CDP,782,342,440
1600000US0677805,0677805,"Tamalpais-Homestead Valley CDP, California",Tamalpais-Homestead Valley CDP,12311,10014,2297
1600000US0677860,0677860,"Tancred CDP, California",Tancred CDP,19,16,3
1600000US0677924,0677924,"Tara Hills CDP, California",Tara Hills CDP,4893,3386,1507
1600000US0677934,0677934,"Tarina CDP, California",Tarina CDP,0,0,0
1600000US0677960,0677960,"Tarpey Village CDP, California",Tarpey Village CDP,4213,3023,1190
1600000US0678008,0678008,"Taylorsville CDP, California",Taylorsville CDP,35,7,28
1600000US0678050,0678050,"Tecopa CDP, California",Tecopa CDP,212,186,26
1600000US0678092,0678092,"Tehachapi city, California",Tehachapi city,8453,5441,3012
1600000US0678106,0678106,"Tehama city, California",Tehama city,503,342,161
1600000US0678120,0678120,"Temecula city, California",Temecula city,113052,74453,38599
1600000US0678126,0678126,"Temelec CDP, California",Temelec CDP,1915,1812,103
1600000US0678138,0678138,"Temescal Valley CDP, California",Temescal Valley CDP,28413,23307,5106
1600000US0678148,0678148,"Temple City city, California",Temple City city,35223,21914,13309
1600000US0678162,0678162,"Templeton CDP, California",Templeton CDP,7871,6118,1753
1600000US0678176,0678176,"Tennant CDP, California",Tennant CDP,21,21,0
1600000US0678232,0678232,"Terminous CDP, California",Terminous CDP,400,337,63
1600000US0678288,0678288,"Terra Bella CDP, California",Terra Bella CDP,2369,1295,1074
1600000US0678336,0678336,"Teviston CDP, California",Teviston CDP,903,162,741
1600000US0678456,0678456,"Thermal CDP, California",Thermal CDP,1366,842,524
1600000US0678470,0678470,"Thermalito CDP, California",Thermalito CDP,6467,4116,2351
1600000US0678568,0678568,"Thornton CDP, California",Thornton CDP,903,365,538
1600000US0678582,0678582,"Thousand Oaks city, California",Thousand Oaks city,125678,88144,37534
1600000US0678596,0678596,"Thousand Palms CDP, California",Thousand Palms CDP,8137,5148,2989
1600000US0678638,0678638,"Three Rivers CDP, California",Three Rivers CDP,2695,1852,843
1600000US0678652,0678652,"Three Rocks CDP, California",Three Rocks CDP,97,97,0
1600000US0678666,0678666,"Tiburon town, California",Tiburon town,9136,6680,2456
1600000US0678715,0678715,"Timber Cove CDP, California",Timber Cove CDP,107,97,10
1600000US0678750,0678750,"Tipton CDP, California",Tipton CDP,3391,1389,2002
1600000US0678792,0678792,"Tobin CDP, California",Tobin CDP,0,0,0
1600000US0678890,0678890,"Tomales CDP, California",Tomales CDP,160,160,0
1600000US0678932,0678932,"Tonyville CDP, California",Tonyville CDP,236,65,171
1600000US0678949,0678949,"Tooleville CDP, California",Tooleville CDP,184,15,169
1600000US0678960,0678960,"Topanga CDP, California",Topanga CDP,8098,6174,1924
1600000US0679030,0679030,"Topaz CDP, California",Topaz CDP,369,336,33
1600000US0679529,0679529,"Toro Canyon CDP, California",Toro Canyon CDP,1908,1596,312
1600000US0680000,0680000,"Torrance city, California",Torrance city,142991,80539,62452
1600000US0680210,0680210,"Trabuco Canyon CDP, California",Trabuco Canyon CDP,1146,1059,87
1600000US0680238,0680238,"Tracy city, California",Tracy city,91203,56408,34795
1600000US0680266,0680266,"Tranquillity CDP, California",Tranquillity CDP,807,559,248
1600000US0680280,0680280,"Traver CDP, California",Traver CDP,702,418,284
1600000US0680364,0680364,"Tres Pinos CDP, California",Tres Pinos CDP,921,772,149
1600000US0680448,0680448,"Trinidad city, California",Trinidad city,348,207,141
1600000US0680476,0680476,"Trinity Center CDP, California",Trinity Center CDP,265,243,22
1600000US0680483,0680483,"Trinity Village CDP, California",Trinity Village CDP,248,201,47
1600000US0680515,0680515,"Trona CDP, California",Trona CDP,69,17,52
1600000US0680560,0680560,"Trowbridge CDP, California",Trowbridge CDP,196,196,0
1600000US0680588,0680588,"Truckee town, California",Truckee town,16666,13651,3015
1600000US0680644,0680644,"Tulare city, California",Tulare city,64198,36225,27973
1600000US0680686,0680686,"Tulelake city, California",Tulelake city,839,411,428
1600000US0680763,0680763,"Tuolumne City CDP, California",Tuolumne City CDP,1398,747,651
1600000US0680784,0680784,"Tupman CDP, California",Tupman CDP,134,85,49
1600000US0680812,0680812,"Turlock city, California",Turlock city,72103,39493,32610
1600000US0680854,0680854,"Tustin city, California",Tustin city,79848,39130,40718
1600000US0680882,0680882,"Tuttle CDP, California",Tuttle CDP,97,97,0
1600000US0680896,0680896,"Tuttletown CDP, California",Tuttletown CDP,770,434,336
1600000US0680952,0680952,"Twain CDP, California",Twain CDP,303,129,174
1600000US0680966,0680966,"Twain Harte CDP, California",Twain Harte CDP,2502,1860,642
1600000US0680994,0680994,"Twentynine Palms city, California",Twentynine Palms city,23388,6222,17166
1600000US0681048,0681048,"Twin Lakes CDP (Mono County), California",Twin Lakes CDP (Mono County),117,117,0
1600000US0681050,0681050,"Twin Lakes CDP (Santa Cruz County), California",Twin Lakes CDP (Santa Cruz County),5410,2400,3010
1600000US0681134,0681134,"Ukiah city, California",Ukiah city,15238,7938,7300
1600000US0681204,0681204,"Union City city, California",Union City city,74338,48803,25535
1600000US0681302,0681302,"University of California-Davis CDP, California",University of California-Davis CDP,4391,15,4376
1600000US0681312,0681312,"University of California-Merced CDP, California",University of California-Merced CDP,0,0,0
1600000US0681316,0681316,"University of California-Santa Barbara CDP, California",University of California-Santa Barbara CDP,1735,404,1331
1600000US0681344,0681344,"Upland city, California",Upland city,76672,42197,34475
1600000US0681358,0681358,"Upper Lake CDP, California",Upper Lake CDP,1232,1157,75
1600000US0681554,0681554,"Vacaville city, California",Vacaville city,92847,61917,30930
1600000US0681638,0681638,"Valinda CDP, California",Valinda CDP,22580,17034,5546
1600000US0681652,0681652,"Vallecito CDP, California",Vallecito CDP,132,98,34
1600000US0681666,0681666,"Vallejo city, California",Vallejo city,119774,70167,49607
1600000US0681708,0681708,"Valle Vista CDP, California",Valle Vista CDP,19065,14251,4814
1600000US0681722,0681722,"Valley Acres CDP, California",Valley Acres CDP,641,407,234
1600000US0681736,0681736,"Valley Center CDP, California",Valley Center CDP,11261,9559,1702
1600000US0681778,0681778,"Valley Ford CDP, California",Valley Ford CDP,0,0,0
1600000US0681792,0681792,"Valley Home CDP, California",Valley Home CDP,209,198,11
1600000US0681869,0681869,"Valley Ranch CDP, California",Valley Ranch CDP,38,38,0
1600000US0681890,0681890,"Valley Springs CDP, California",Valley Springs CDP,3890,2688,1202
1600000US0681925,0681925,"Valley Wells CDP, California",Valley Wells CDP,0,0,0
1600000US0681967,0681967,"Val Verde CDP, California",Val Verde CDP,3261,2672,589
1600000US0682072,0682072,"Vandenberg AFB CDP, California",Vandenberg AFB CDP,3205,0,3205
1600000US0682086,0682086,"Vandenberg Village CDP, California",Vandenberg Village CDP,7919,5972,1947
1600000US0682334,0682334,"Verdi CDP, California",Verdi CDP,154,145,9
1600000US0682422,0682422,"Vernon city, California",Vernon city,248,15,233
1600000US0682562,0682562,"Victor CDP, California",Victor CDP,420,196,224
1600000US0682590,0682590,"Victorville city, California",Victorville city,118758,65127,53631
1600000US0682667,0682667,"View Park-Windsor Hills CDP, California",View Park-Windsor Hills CDP,11505,8923,2582
1600000US0682744,0682744,"Villa Park city, California",Villa Park city,5822,5583,239
1600000US0682786,0682786,"Vina CDP, California",Vina CDP,117,87,30
1600000US0682815,0682815,"Vincent CDP, California",Vincent CDP,16379,13291,3088
1600000US0682842,0682842,"Vine Hill CDP, California",Vine Hill CDP,3228,2375,853
1600000US0682852,0682852,"Vineyard CDP, California",Vineyard CDP,39588,29467,10121
1600000US0682929,0682929,"Virginia Lakes CDP, California",Virginia Lakes CDP,0,0,0
1600000US0682954,0682954,"Visalia city, California",Visalia city,131112,75784,55328
1600000US0682996,0682996,"Vista city, California",Vista city,98651,46917,51734
1600000US0683085,0683085,"Vista Santa Rosa CDP, California",Vista Santa Rosa CDP,2072,1990,82
1600000US0683094,0683094,"Volcano CDP, California",Volcano CDP,45,45,0
1600000US0683108,0683108,"Volta CDP, California",Volta CDP,133,34,99
1600000US0683262,0683262,"Walker CDP, California",Walker CDP,398,374,24
1600000US0683304,0683304,"Wallace CDP, California",Wallace CDP,721,721,0
1600000US0683332,0683332,"Walnut city, California",Walnut city,29711,23982,5729
1600000US0683346,0683346,"Walnut Creek city, California",Walnut Creek city,68808,44423,24385
1600000US0683374,0683374,"Walnut Grove CDP, California",Walnut Grove CDP,1288,682,606
1600000US0683402,0683402,"Walnut Park CDP, California",Walnut Park CDP,15939,9427,6512
1600000US0683460,0683460,"Warm Springs CDP, California",Warm Springs CDP,1445,915,530
1600000US0683494,0683494,"Warner Valley CDP, California",Warner Valley CDP,0,0,0
1600000US0683542,0683542,"Wasco city, California",Wasco city,21965,14327,7638
1600000US0683570,0683570,"Washington CDP, California",Washington CDP,137,118,19
1600000US0683612,0683612,"Waterford city, California",Waterford city,8884,5703,3181
1600000US0683626,0683626,"Waterloo CDP, California",Waterloo CDP,902,181,721
1600000US0683668,0683668,"Watsonville city, California",Watsonville city,51979,22123,29856
1600000US0683724,0683724,"Waukena CDP, California",Waukena CDP,51,18,33
1600000US0683730,0683730,"Wautec CDP, California",Wautec CDP,15,8,7
1600000US0683766,0683766,"Wawona CDP, California",Wawona CDP,144,17,127
1600000US0683794,0683794,"Weaverville CDP, California",Weaverville CDP,3229,1634,1595
1600000US0683850,0683850,"Weed city, California",Weed city,2528,751,1777
1600000US0683863,0683863,"Weedpatch CDP, California",Weedpatch CDP,2879,1125,1754
1600000US0683906,0683906,"Weitchpec CDP, California",Weitchpec CDP,58,49,9
1600000US0683948,0683948,"Weldon CDP, California",Weldon CDP,2160,1515,645
1600000US0684004,0684004,"Weott CDP, California",Weott CDP,124,124,0
1600000US0684116,0684116,"West Athens CDP, California",West Athens CDP,9526,6160,3366
1600000US0684120,0684120,"West Bishop CDP, California",West Bishop CDP,2553,2262,291
1600000US0684144,0684144,"West Carson CDP, California",West Carson CDP,21887,16138,5749
1600000US0684200,0684200,"West Covina city, California",West Covina city,104894,68057,36837
1600000US0684345,0684345,"West Goshen CDP, California",West Goshen CDP,674,324,350
1600000US0684385,0684385,"Westhaven-Moonstone CDP, California",Westhaven-Moonstone CDP,1302,904,398
1600000US0684410,0684410,"West Hollywood city, California",West Hollywood city,35327,7088,28239
1600000US0684438,0684438,"Westlake Village city, California",Westlake Village city,8130,6663,1467
1600000US0684480,0684480,"Westley CDP, California",Westley CDP,689,183,506
1600000US0684536,0684536,"West Menlo Park CDP, California",West Menlo Park CDP,3707,2944,763
1600000US0684550,0684550,"Westminster city, California",Westminster city,90554,49736,40818
1600000US0684578,0684578,"West Modesto CDP, California",West Modesto CDP,5514,2039,3475
1600000US0684592,0684592,"Westmont CDP, California",Westmont CDP,35052,11191,23861
1600000US0684606,0684606,"Westmorland city, California",Westmorland city,2680,1118,1562
1600000US0684680,0684680,"West Park CDP, California",West Park CDP,1025,546,479
1600000US0684732,0684732,"West Point CDP, California",West Point CDP,640,586,54
1600000US0684774,0684774,"West Puente Valley CDP, California",West Puente Valley CDP,23504,19043,4461
1600000US0684780,0684780,"West Rancho Dominguez CDP, California",West Rancho Dominguez CDP,21596,16151,5445
1600000US0684816,0684816,"West Sacramento city, California",West Sacramento city,53116,30728,22388
1600000US0684863,0684863,"Westside CDP, California",Westside CDP,213,28,185
1600000US0684921,0684921,"West Whittier-Los Nietos CDP, California",West Whittier-Los Nietos CDP,26025,18819,7206
1600000US0684928,0684928,"Westwood CDP, California",Westwood CDP,1387,811,576
1600000US0685012,0685012,"Wheatland city, California",Wheatland city,3608,2327,1281
1600000US0685086,0685086,"Whitehawk CDP, California",Whitehawk CDP,37,37,0
1600000US0685208,0685208,"Whitewater CDP, California",Whitewater CDP,1154,759,395
1600000US0685222,0685222,"Whitley Gardens CDP, California",Whitley Gardens CDP,44,44,0
1600000US0685250,0685250,"Whitmore CDP, California",Whitmore CDP,402,383,19
1600000US0685292,0685292,"Whittier city, California",Whittier city,83117,50313,32804
1600000US0685446,0685446,"Wildomar city, California",Wildomar city,36003,26832,9171
1600000US0685551,0685551,"Wilkerson CDP, California",Wilkerson CDP,495,438,57
1600000US0685586,0685586,"Williams city, California",Williams city,5164,2915,2249
1600000US0685587,0685587,"Williams Canyon CDP, California",Williams Canyon CDP,108,108,0
1600000US0685600,0685600,"Willits city, California",Willits city,4810,1679,3131
1600000US0685614,0685614,"Willowbrook CDP, California",Willowbrook CDP,24218,11128,13090
1600000US0685642,0685642,"Willow Creek CDP, California",Willow Creek CDP,1241,651,590
1600000US0685684,0685684,"Willows city, California",Willows city,5873,3306,2567
1600000US0685866,0685866,"Wilsonia CDP, California",Wilsonia CDP,0,0,0
1600000US0685880,0685880,"Wilton CDP, California",Wilton CDP,5192,4282,910
1600000US0685894,0685894,"Winchester CDP, California",Winchester CDP,2957,2461,496
1600000US0685922,0685922,"Windsor town, California",Windsor town,27570,21593,5977
1600000US0685992,0685992,"Winter Gardens CDP, California",Winter Gardens CDP,22625,14317,8308
1600000US0686020,0686020,"Winterhaven CDP, California",Winterhaven CDP,151,131,20
1600000US0686034,0686034,"Winters city, California",Winters city,7276,4775,2501
1600000US0686076,0686076,"Winton CDP, California",Winton CDP,11619,6608,5011
1600000US0686174,0686174,"Wofford Heights CDP, California",Wofford Heights CDP,1870,1160,710
1600000US0686216,0686216,"Woodacre CDP, California",Woodacre CDP,1464,1250,214
1600000US0686230,0686230,"Woodbridge CDP, California",Woodbridge CDP,3783,2763,1020
1600000US0686244,0686244,"Woodcrest CDP, California",Woodcrest CDP,18462,16683,1779
1600000US0686300,0686300,"Woodlake city, California",Woodlake city,7700,3956,3744
1600000US0686328,0686328,"Woodland city, California",Woodland city,58621,31616,27005
1600000US0686380,0686380,"Woodlands CDP, California",Woodlands CDP,2331,1985,346
1600000US0686440,0686440,"Woodside town, California",Woodside town,5593,4864,729
1600000US0686482,0686482,"Woodville CDP, California",Woodville CDP,1836,1172,664
1600000US0686489,0686489,"Woodville Farm Labor Camp CDP, California",Woodville Farm Labor Camp CDP,701,0,701
1600000US0686496,0686496,"Woody CDP, California",Woody CDP,67,67,0
1600000US0686594,0686594,"Wrightwood CDP, California",Wrightwood CDP,4362,3481,881
1600000US0686678,0686678,"Yankee Hill CDP, California",Yankee Hill CDP,256,213,43
1600000US0686720,0686720,"Yermo CDP, California",Yermo CDP,1082,443,639
1600000US0686734,0686734,"Yettem CDP, California",Yettem CDP,487,10,477
1600000US0686804,0686804,"Yolo CDP, California",Yolo CDP,196,185,11
1600000US0686832,0686832,"Yorba Linda city, California",Yorba Linda city,67791,56226,11565
1600000US0686878,0686878,"Yosemite Lakes CDP, California",Yosemite Lakes CDP,5303,4293,1010
1600000US0686912,0686912,"Yosemite Valley CDP, California",Yosemite Valley CDP,234,0,234
1600000US0686916,0686916,"Yosemite West CDP, California",Yosemite West CDP,26,26,0
1600000US0686930,0686930,"Yountville city, California",Yountville city,2453,1416,1037
1600000US0686944,0686944,"Yreka city, California",Yreka city,7539,4352,3187
1600000US0686972,0686972,"Yuba City city, California",Yuba City city,65836,35553,30283
1600000US0687042,0687042,"Yucaipa city, California",Yucaipa city,53873,38899,14974
1600000US0687056,0687056,"Yucca Valley town, California",Yucca Valley town,21502,13642,7860
1600000US0687090,0687090,"Zayante CDP, California",Zayante CDP,765,690,75