fips,name,name-cdp,total-housing-units,margin-of-error-total,owner-occupied-units,marin-of-error-owner,renter-occupied,margin-of-error-renter
1600000US0600135,Acalanes Ridge CDP,"Acalanes Ridge CDP, California",875,250,788,247,87,113
1600000US0600156,Acampo CDP,"Acampo CDP, California",261,269,109,166,152,198
1600000US0600212,Acton CDP,"Acton CDP, California",7043,756,6416,742,627,328
1600000US0600296,Adelanto city,"Adelanto city, California",31469,645,17761,1667,13708,1668
1600000US0600310,Adin CDP,"Adin CDP, California",180,108,116,67,64,85
1600000US0600394,Agoura Hills city,"Agoura Hills city, California",20157,61,16135,830,4022,837
1600000US0600450,Agua Dulce CDP,"Agua Dulce CDP, California",3494,614,3084,572,410,300
1600000US0600464,Aguanga CDP,"Aguanga CDP, California",696,344,425,283,271,235
1600000US0600478,Ahwahnee CDP,"Ahwahnee CDP, California",2256,562,1434,479,822,451
1600000US0600535,Airport CDP,"Airport CDP, California",1276,318,450,342,826,330
1600000US0600562,Alameda city,"Alameda city, California",78693,261,42250,1764,36443,1806
1600000US0600618,Alamo CDP,"Alamo CDP, California",13818,1313,12890,1284,928,467
1600000US0600674,Albany city,"Albany city, California",20084,44,10055,716,10029,723
1600000US0600716,Albion CDP,"Albion CDP, California",113,103,113,103,0,13
1600000US0600786,Alderpoint CDP,"Alderpoint CDP, California",26,39,26,39,0,13
1600000US0600884,Alhambra city,"Alhambra city, California",83723,149,34101,1788,49622,1798
1600000US0600898,Alhambra Valley CDP,"Alhambra Valley CDP, California",1051,379,998,393,53,64
1600000US0600947,Aliso Viejo city,"Aliso Viejo city, California",49968,130,30363,1436,19605,1440
1600000US0600982,Alleghany CDP,"Alleghany CDP, California",99,101,99,101,0,13
1600000US0600996,Allendale CDP,"Allendale CDP, California",1421,382,1320,369,101,115
1600000US0601010,Allensworth CDP,"Allensworth CDP, California",596,153,274,94,322,137
1600000US0601094,Almanor CDP,"Almanor CDP, California",0,13,0,13,0,13
1600000US0601150,Alondra Park CDP,"Alondra Park CDP, California",7965,971,4272,605,3693,705
1600000US0601164,Alpaugh CDP,"Alpaugh CDP, California",869,333,189,97,680,308
1600000US0601192,Alpine CDP,"Alpine CDP, California",14757,1362,10928,1316,3829,698
1600000US0601228,Alpine Village CDP,"Alpine Village CDP, California",142,60,114,59,28,22
1600000US0601276,Alta CDP,"Alta CDP, California",681,238,628,239,53,36
1600000US0601290,Altadena CDP,"Altadena CDP, California",42454,1977,30024,2031,12430,1594
1600000US0601358,Alta Sierra CDP (Kern County),"Alta Sierra CDP (Kern County), California",111,144,97,142,14,21
1600000US0601360,Alta Sierra CDP (Nevada County),"Alta Sierra CDP (Nevada County), California",7600,772,6969,865,631,423
1600000US0601416,Alto CDP,"Alto CDP, California",818,320,371,183,447,321
1600000US0601444,Alturas city,"Alturas city, California",2521,27,1631,220,890,220
1600000US0601458,Alum Rock CDP,"Alum Rock CDP, California",11449,1145,8363,1135,3086,804
1600000US0601514,Amador City city,"Amador City city, California",153,77,57,38,96,67
1600000US0601518,Amador Pines CDP,"Amador Pines CDP, California",992,227,955,217,37,47
1600000US0601640,American Canyon city,"American Canyon city, California",20175,45,15577,771,4598,777
1600000US0601651,Amesti CDP,"Amesti CDP, California",3218,431,2610,474,608,254
1600000US0602000,Anaheim city,"Anaheim city, California",348146,483,156411,5007,191735,4894
1600000US0602028,Anchor Bay CDP,"Anchor Bay CDP, California",326,171,191,120,135,134
1600000US0602042,Anderson city,"Anderson city, California",10466,42,5239,578,5227,583
1600000US0602112,Angels city,"Angels city, California",3889,34,2222,473,1667,475
1600000US0602168,Angwin CDP,"Angwin CDP, California",2278,421,1235,344,1043,301
1600000US0602210,Antelope CDP,"Antelope CDP, California",48356,2190,32067,1882,16289,1645
1600000US0602252,Antioch city,"Antioch city, California",110901,134,64814,3025,46087,3024
1600000US0602294,Anza CDP,"Anza CDP, California",2101,899,1612,822,489,379
1600000US0602364,Apple Valley town,"Apple Valley town, California",72815,191,45399,2241,27416,2214
1600000US0602378,Aptos CDP,"Aptos CDP, California",6245,729,4845,529,1400,597
1600000US0602382,Aptos Hills-Larkin Valley CDP,"Aptos Hills-Larkin Valley CDP, California",1397,326,1277,324,120,98
1600000US0602420,Arbuckle CDP,"Arbuckle CDP, California",3368,494,2314,563,1054,433
1600000US0602462,Arcadia city,"Arcadia city, California",56384,380,34870,1849,21514,1779
1600000US0602476,Arcata city,"Arcata city, California",16493,478,5408,785,11085,801
1600000US0602553,Arden-Arcade CDP,"Arden-Arcade CDP, California",92879,3109,39760,2473,53119,2733
1600000US0602700,Armona CDP,"Armona CDP, California",4433,732,2662,816,1771,570
1600000US0602770,Arnold CDP,"Arnold CDP, California",2099,319,1705,279,394,203
1600000US0602812,Aromas CDP,"Aromas CDP, California",2609,639,1966,527,643,524
1600000US0602868,Arroyo Grande city,"Arroyo Grande city, California",17697,112,11781,1017,5916,1015
1600000US0602896,Artesia city,"Artesia city, California",16015,145,8397,874,7618,882
1600000US0602910,Artois CDP,"Artois CDP, California",236,127,102,82,134,105
1600000US0602924,Arvin city,"Arvin city, California",21102,90,10677,1000,10425,998
1600000US0602980,Ashland CDP,"Ashland CDP, California",23400,1519,8376,1047,15024,1529
1600000US0603026,Aspen Springs CDP,"Aspen Springs CDP, California",56,64,40,56,16,29
1600000US0603064,Atascadero city,"Atascadero city, California",30075,224,19741,934,10334,896
1600000US0603092,Atherton town,"Atherton town, California",6485,157,5862,317,623,273
1600000US0603162,Atwater city,"Atwater city, California",30195,117,15479,1371,14716,1384
1600000US0603190,Auberry CDP,"Auberry CDP, California",3275,504,2627,475,648,245
1600000US0603204,Auburn city,"Auburn city, California",13785,137,8578,643,5207,647
1600000US0603205,Auburn Lake Trails CDP,"Auburn Lake Trails CDP, California",3495,574,3000,532,495,283
1600000US0603209,August CDP,"August CDP, California",7933,1633,4144,1509,3789,761
1600000US0603274,Avalon city,"Avalon city, California",3711,33,1128,450,2583,448
1600000US0603302,Avenal city,"Avenal city, California",10305,350,4970,964,5335,969
1600000US0603316,Avery CDP,"Avery CDP, California",444,230,271,127,173,195
1600000US0603330,Avila Beach CDP,"Avila Beach CDP, California",1455,514,1130,484,325,272
1600000US0603344,Avocado Heights CDP,"Avocado Heights CDP, California",13719,1286,10280,1357,3439,826
1600000US0603386,Azusa city,"Azusa city, California",44353,597,22816,1485,21537,1442
1600000US0603512,Baker CDP,"Baker CDP, California",596,208,171,138,425,157
1600000US0603526,Bakersfield city,"Bakersfield city, California",375470,580,229340,4565,146130,4606
1600000US0603546,Bakersfield Country Club CDP,"Bakersfield Country Club CDP, California",1486,234,1418,226,68,57
1600000US0603666,Baldwin Park city,"Baldwin Park city, California",75178,191,43368,1889,31810,1930
1600000US0603694,Ballard CDP,"Ballard CDP, California",764,266,572,244,192,118
1600000US0603708,Ballico CDP,"Ballico CDP, California",508,176,236,118,272,144
1600000US0603792,Bangor CDP,"Bangor CDP, California",407,177,388,171,19,30
1600000US0603820,Banning city,"Banning city, California",29978,133,18707,1198,11271,1219
1600000US0604030,Barstow city,"Barstow city, California",23248,188,9595,1109,13653,1117
1600000US0604198,Bass Lake CDP,"Bass Lake CDP, California",291,172,291,172,0,13
1600000US0604415,Bay Point CDP,"Bay Point CDP, California",25337,2187,13903,1655,11434,2260
1600000US0604470,Bayview CDP (Contra Costa County),"Bayview CDP (Contra Costa County), California",2745,1018,1858,414,887,1003
1600000US0604478,Bayview CDP (Humboldt County),"Bayview CDP (Humboldt County), California",2770,531,1980,463,790,289
1600000US0604549,Baywood Park CDP,"Baywood Park CDP, California",1775,295,1697,298,78,72
1600000US0604576,Beale AFB CDP,"Beale AFB CDP, California",955,142,0,13,955,142
1600000US0604632,Bear Creek CDP,"Bear Creek CDP, California",95,104,69,104,26,35
1600000US0604716,Bear Valley CDP (Alpine County),"Bear Valley CDP (Alpine County), California",91,69,75,65,16,18
1600000US0604730,Bear Valley CDP (Mariposa County),"Bear Valley CDP (Mariposa County), California",135,115,135,115,0,13
1600000US0604734,Bear Valley Springs CDP,"Bear Valley Springs CDP, California",5286,848,4832,857,454,317
1600000US0604758,Beaumont city,"Beaumont city, California",48096,131,38081,1648,10015,1635
1600000US0604772,Beckwourth CDP,"Beckwourth CDP, California",388,238,388,238,0,13
1600000US0604856,Belden CDP,"Belden CDP, California",0,13,0,13,0,13
1600000US0604870,Bell city,"Bell city, California",34423,478,12644,1458,21779,1549
1600000US0604926,Bella Vista CDP,"Bella Vista CDP, California",3315,498,2792,418,523,231
1600000US0604938,Bell Canyon CDP,"Bell Canyon CDP, California",1991,265,1829,282,162,139
1600000US0604982,Bellflower city,"Bellflower city, California",75650,198,30555,1919,45095,1912
1600000US0604996,Bell Gardens city,"Bell Gardens city, California",41364,244,10299,1214,31065,1224
1600000US0605108,Belmont city,"Belmont city, California",26327,187,16604,942,9723,932
1600000US0605164,Belvedere city,"Belvedere city, California",2246,235,1782,228,464,149
1600000US0605262,Benbow CDP,"Benbow CDP, California",150,77,135,74,15,22
1600000US0605276,Bend CDP,"Bend CDP, California",425,190,425,190,0,13
1600000US0605290,Benicia city,"Benicia city, California",28134,74,20279,837,7855,838
1600000US0605332,Ben Lomond CDP,"Ben Lomond CDP, California",7272,990,4975,763,2297,804
1600000US0605346,Benton CDP,"Benton CDP, California",244,136,229,136,15,18
1600000US0605356,Benton Park CDP,"Benton Park CDP, California",5203,776,3210,810,1993,643
1600000US0606000,Berkeley city,"Berkeley city, California",109964,801,51131,2005,58833,2040
1600000US0606028,Bermuda Dunes CDP,"Bermuda Dunes CDP, California",6620,847,3860,690,2760,552
1600000US0606070,Berry Creek CDP,"Berry Creek CDP, California",1278,315,963,292,315,172
1600000US0606150,Bertsch-Oceanview CDP,"Bertsch-Oceanview CDP, California",2037,540,1611,516,426,197
1600000US0606210,Bethel Island CDP,"Bethel Island CDP, California",2015,472,1741,459,274,212
1600000US0606308,Beverly Hills city,"Beverly Hills city, California",33684,42,17007,1363,16677,1364
1600000US0606336,Bieber CDP,"Bieber CDP, California",145,89,105,79,40,43
1600000US0606406,Big Bear City CDP,"Big Bear City CDP, California",12600,1294,7501,877,5099,959
1600000US0606434,Big Bear Lake city,"Big Bear Lake city, California",5276,38,2788,410,2488,414
1600000US0606475,Big Bend CDP,"Big Bend CDP, California",187,142,160,138,27,25
1600000US0606518,Big Creek CDP,"Big Creek CDP, California",159,89,39,47,120,77
1600000US0606560,Biggs city,"Biggs city, California",2648,573,2032,554,616,306
1600000US0606567,Big Lagoon CDP,"Big Lagoon CDP, California",92,37,78,34,14,13
1600000US0606616,Big Pine CDP,"Big Pine CDP, California",1373,173,1163,190,210,67
1600000US0606635,Big River CDP,"Big River CDP, California",1158,200,768,122,390,170
1600000US0606728,Biola CDP,"Biola CDP, California",1440,383,677,315,763,317
1600000US0606798,Bishop city,"Bishop city, California",3641,92,2000,393,1641,382
1600000US0606928,Blackhawk CDP,"Blackhawk CDP, California",10537,1078,9689,1008,848,346
1600000US0606935,Blacklake CDP,"Blacklake CDP, California",797,225,756,225,41,48
1600000US0606982,Black Point-Green Point CDP,"Black Point-Green Point CDP, California",1738,296,1497,301,241,156
1600000US0606994,Blairsden CDP,"Blairsden CDP, California",0,13,0,13,0,13
1600000US0607036,Bloomfield CDP,"Bloomfield CDP, California",243,130,183,107,60,79
1600000US0607064,Bloomington CDP,"Bloomington CDP, California",21696,1877,14874,1789,6822,1265
1600000US0607162,Blue Lake city,"Blue Lake city, California",934,186,540,125,394,162
1600000US0607172,Bluewater CDP,"Bluewater CDP, California",142,65,142,65,0,13
1600000US0607218,Blythe city,"Blythe city, California",13076,797,7453,880,5623,850
1600000US0607246,Bodega CDP,"Bodega CDP, California",590,317,529,328,61,67
1600000US0607260,Bodega Bay CDP,"Bodega Bay CDP, California",1004,581,630,477,374,240
1600000US0607274,Bodfish CDP,"Bodfish CDP, California",2164,681,991,305,1173,665
1600000US0607316,Bolinas CDP,"Bolinas CDP, California",1205,313,875,246,330,233
1600000US0607372,Bombay Beach CDP,"Bombay Beach CDP, California",215,157,185,159,30,44
1600000US0607378,Bonadelle Ranchos CDP,"Bonadelle Ranchos CDP, California",5191,790,4664,766,527,308
1600000US0607414,Bonita CDP,"Bonita CDP, California",12345,1489,10045,1445,2300,599
1600000US0607470,Bonny Doon CDP,"Bonny Doon CDP, California",2808,480,2382,431,426,186
1600000US0607498,Bonsall CDP,"Bonsall CDP, California",4194,528,2758,471,1436,422
1600000US0607512,Boonville CDP,"Boonville CDP, California",992,227,512,227,480,159
1600000US0607525,Bootjack CDP,"Bootjack CDP, California",431,247,220,129,211,234
1600000US0607568,Boron CDP,"Boron CDP, California",2280,392,1149,202,1131,389
1600000US0607578,Boronda CDP,"Boronda CDP, California",1740,650,682,336,1058,578
1600000US0607596,Borrego Springs CDP,"Borrego Springs CDP, California",1864,540,1713,537,151,122
1600000US0607624,Bostonia CDP,"Bostonia CDP, California",17431,2034,6593,1245,10838,1608
1600000US0607652,Boulder Creek CDP,"Boulder Creek CDP, California",5305,819,4461,855,844,381
1600000US0607694,Boulevard CDP,"Boulevard CDP, California",453,192,210,217,243,187
1600000US0607750,Bowles CDP,"Bowles CDP, California",234,167,99,99,135,166
1600000US0607848,Boyes Hot Springs CDP,"Boyes Hot Springs CDP, California",7973,1366,3096,575,4877,1259
1600000US0607946,Bradbury city,"Bradbury city, California",825,145,726,140,99,64
1600000US0607974,Bradley CDP,"Bradley CDP, California",99,61,75,48,24,37
1600000US0608058,Brawley city,"Brawley city, California",25826,94,13436,1318,12390,1321
1600000US0608100,Brea city,"Brea city, California",44067,87,28228,1354,15839,1355
1600000US0608142,Brentwood city,"Brentwood city, California",62801,163,49031,1601,13770,1619
1600000US0608172,Bret Harte CDP,"Bret Harte CDP, California",5020,941,2341,511,2679,925
1600000US0608240,Bridgeport CDP,"Bridgeport CDP, California",473,354,455,354,18,26
1600000US0608310,Brisbane city,"Brisbane city, California",4633,29,3760,301,873,309
1600000US0608338,Broadmoor CDP,"Broadmoor CDP, California",4102,834,3311,620,791,679
1600000US0608478,Brookdale CDP,"Brookdale CDP, California",1293,373,1082,373,211,129
1600000US0608506,Brooks CDP,"Brooks CDP, California",41,67,0,13,41,67
1600000US0608530,Brooktrails CDP,"Brooktrails CDP, California",4559,773,3323,731,1236,524
1600000US0608680,Buckhorn CDP,"Buckhorn CDP, California",2175,371,1762,359,413,255
1600000US0608716,Buck Meadows CDP,"Buck Meadows CDP, California",0,13,0,13,0,13
1600000US0608744,Bucks Lake CDP,"Bucks Lake CDP, California",21,34,21,34,0,13
1600000US0608758,Buellton city,"Buellton city, California",5276,51,3169,523,2107,514
1600000US0608786,Buena Park city,"Buena Park city, California",81372,189,46942,2546,34430,2530
1600000US0608828,Buena Vista CDP,"Buena Vista CDP, California",573,251,415,223,158,118
1600000US0608954,Burbank city,"Burbank city, California",102887,153,49724,2381,53163,2368
1600000US0608968,Burbank CDP,"Burbank CDP, California",5377,829,3185,818,2192,458
1600000US0609066,Burlingame city,"Burlingame city, California",29581,164,17001,1123,12580,1085
1600000US0609122,Burney CDP,"Burney CDP, California",3654,431,2421,427,1233,432
1600000US0609150,Burnt Ranch CDP,"Burnt Ranch CDP, California",185,77,177,76,8,14
1600000US0609310,Butte Creek Canyon CDP,"Butte Creek Canyon CDP, California",677,263,613,257,64,71
1600000US0609318,Butte Meadows CDP,"Butte Meadows CDP, California",25,36,25,36,0,13
1600000US0609324,Butte Valley CDP,"Butte Valley CDP, California",899,382,817,386,82,93
1600000US0609332,Buttonwillow CDP,"Buttonwillow CDP, California",1331,321,550,165,781,280
1600000US0609346,Byron CDP,"Byron CDP, California",1968,888,1346,826,622,373
1600000US0609353,Bystrom CDP,"Bystrom CDP, California",3714,614,1834,496,1880,693
1600000US0609360,Cabazon CDP,"Cabazon CDP, California",2254,638,1497,659,757,396
1600000US0609598,Calabasas city,"Calabasas city, California",23834,53,16108,971,7726,979
1600000US0609710,Calexico city,"Calexico city, California",39758,47,23528,2460,16230,2457
1600000US0609780,California City city,"California City city, California",11691,484,6587,955,5104,1107
1600000US0609822,California Hot Springs CDP,"California Hot Springs CDP, California",40,39,40,39,0,13
1600000US0609834,California Pines CDP,"California Pines CDP, California",367,174,247,140,120,123
1600000US0609835,California Polytechnic State University CDP,"California Polytechnic State University CDP, California",161,79,138,74,23,26
1600000US0609864,Calimesa city,"Calimesa city, California",9103,38,7607,613,1496,617
1600000US0609878,Calipatria city,"Calipatria city, California",3063,288,1555,357,1508,407
1600000US0609892,Calistoga city,"Calistoga city, California",5273,38,3408,641,1865,638
1600000US0609948,Callender CDP,"Callender CDP, California",1638,623,921,364,717,556
1600000US0609990,Calpella CDP,"Calpella CDP, California",620,299,545,293,75,61
1600000US0610004,Calpine CDP,"Calpine CDP, California",164,91,128,89,36,53
1600000US0610032,Calwa CDP,"Calwa CDP, California",2363,711,868,578,1495,547
1600000US0610042,Camanche North Shore CDP,"Camanche North Shore CDP, California",1188,355,1010,370,178,126
1600000US0610044,Camanche Village CDP,"Camanche Village CDP, California",1344,526,1322,528,22,43
1600000US0610046,Camarillo city,"Camarillo city, California",67484,392,43083,1734,24401,1730
1600000US0610074,Cambria CDP,"Cambria CDP, California",5550,588,4083,588,1467,294
1600000US0610088,Cambrian Park CDP,"Cambrian Park CDP, California",2968,465,2307,415,661,232
1600000US0610256,Cameron Park CDP,"Cameron Park CDP, California",18362,1102,12088,783,6274,873
1600000US0610270,Camino CDP,"Camino CDP, California",2065,395,1465,375,600,283
1600000US0610301,Camino Tassajara CDP,"Camino Tassajara CDP, California",5870,1280,5092,1244,778,480
1600000US0610345,Campbell city,"Campbell city, California",42572,162,21555,1435,21017,1397
1600000US0610494,Camp Nelson CDP,"Camp Nelson CDP, California",0,13,0,13,0,13
1600000US0610508,Campo CDP,"Campo CDP, California",3183,591,2299,568,884,620
1600000US0610554,Camp Pendleton Mainside CDP,"Camp Pendleton Mainside CDP, California",3866,1481,0,19,3866,1481
1600000US0610561,Camp Pendleton South CDP,"Camp Pendleton South CDP, California",14999,2073,0,21,14999,2073
1600000US0610676,Camptonville CDP,"Camptonville CDP, California",175,110,140,111,35,34
1600000US0610732,Canby CDP,"Canby CDP, California",33,52,0,13,33,52
1600000US0610816,Cantua Creek CDP,"Cantua Creek CDP, California",368,268,96,80,272,268
1600000US0610914,Canyondam CDP,"Canyondam CDP, California",0,13,0,13,0,13
1600000US0610928,Canyon Lake city,"Canyon Lake city, California",11225,31,8496,769,2729,769
1600000US0611040,Capitola city,"Capitola city, California",9896,98,4577,720,5319,720
1600000US0611166,Caribou CDP,"Caribou CDP, California",0,13,0,13,0,13
1600000US0611194,Carlsbad city,"Carlsbad city, California",113886,159,72348,2602,41538,2597
1600000US0611250,Carmel-by-the-Sea city,"Carmel-by-the-Sea city, California",3761,42,1871,519,1890,521
1600000US0611324,Carmel Valley Village CDP,"Carmel Valley Village CDP, California",4149,614,3127,662,1022,467
1600000US0611376,Carmet CDP,"Carmet CDP, California",0,13,0,13,0,13
1600000US0611390,Carmichael CDP,"Carmichael CDP, California",73994,2793,40791,2117,33203,2242
1600000US0611418,Carnelian Bay CDP,"Carnelian Bay CDP, California",565,235,460,223,105,90
1600000US0611446,Carpinteria city,"Carpinteria city, California",13416,35,7397,766,6019,767
1600000US0611481,Carrick CDP,"Carrick CDP, California",58,68,58,68,0,13
1600000US0611530,Carson city,"Carson city, California",90530,297,67359,1932,23171,1930
1600000US0611600,Cartago CDP,"Cartago CDP, California",49,53,5,8,44,52
1600000US0611614,Caruthers CDP,"Caruthers CDP, California",2245,467,1694,448,551,313
1600000US0611656,Casa Conejo CDP,"Casa Conejo CDP, California",3173,441,2498,400,675,267
1600000US0611691,Casa de Oro-Mount Helix CDP,"Casa de Oro-Mount Helix CDP, California",19111,1248,14534,1257,4577,757
1600000US0611696,Casa Loma CDP,"Casa Loma CDP, California",1301,427,737,395,564,304
1600000US0611754,Casmalia CDP,"Casmalia CDP, California",88,63,68,59,20,30
1600000US0611768,Caspar CDP,"Caspar CDP, California",302,196,200,179,102,106
1600000US0611782,Cassel CDP,"Cassel CDP, California",266,209,144,125,122,179
1600000US0611796,Castaic CDP,"Castaic CDP, California",18479,1098,15747,1151,2732,589
1600000US0611824,Castella CDP,"Castella CDP, California",230,62,165,53,65,32
1600000US0611915,Castle Hill CDP,"Castle Hill CDP, California",1159,334,1145,339,14,22
1600000US0611964,Castro Valley CDP,"Castro Valley CDP, California",63174,2005,44506,2065,18668,1614
1600000US0611978,Castroville CDP,"Castroville CDP, California",6315,926,2294,644,4021,843
1600000US0612048,Cathedral City city,"Cathedral City city, California",54438,129,32481,1666,21957,1656
1600000US0612062,Catheys Valley CDP,"Catheys Valley CDP, California",741,248,675,240,66,69
1600000US0612132,Cayucos CDP,"Cayucos CDP, California",2228,368,1282,315,946,218
1600000US0612146,Cazadero CDP,"Cazadero CDP, California",320,157,264,147,56,35
1600000US0612216,Cedar Flat CDP,"Cedar Flat CDP, California",886,324,707,309,179,110
1600000US0612300,Cedar Ridge CDP,"Cedar Ridge CDP, California",1267,195,1013,193,254,150
1600000US0612314,Cedar Slope CDP,"Cedar Slope CDP, California",0,13,0,13,0,13
1600000US0612328,Cedarville CDP,"Cedarville CDP, California",695,252,439,206,256,154
1600000US0612412,Centerville CDP (Fresno County),"Centerville CDP (Fresno County), California",314,178,149,144,165,124
1600000US0612415,Centerville CDP (Shasta County),"Centerville CDP (Shasta County), California",2166,340,1952,335,214,161
1600000US0612524,Ceres city,"Ceres city, California",47646,211,28638,1905,19008,1922
1600000US0612552,Cerritos city,"Cerritos city, California",49233,57,36701,1373,12532,1377
1600000US0612594,Chalfant CDP,"Chalfant CDP, California",1010,354,933,363,77,95
1600000US0612612,Challenge-Brownsville CDP,"Challenge-Brownsville CDP, California",1163,632,1014,612,149,184
1600000US0612669,Channel Islands Beach CDP,"Channel Islands Beach CDP, California",2699,558,1307,282,1392,578
1600000US0612730,Charleston View CDP,"Charleston View CDP, California",6,8,6,8,0,13
1600000US0612734,Charter Oak CDP,"Charter Oak CDP, California",9897,1083,6028,831,3869,797
1600000US0612818,Cherokee CDP,"Cherokee CDP, California",100,82,90,87,10,15
1600000US0612860,Cherokee Strip CDP,"Cherokee Strip CDP, California",289,197,78,73,211,211
1600000US0612902,Cherryland CDP,"Cherryland CDP, California",15430,1500,4293,974,11137,1524
1600000US0612916,Cherry Valley CDP,"Cherry Valley CDP, California",7868,1052,6550,975,1318,429
1600000US0612930,Chester CDP,"Chester CDP, California",2050,354,1625,330,425,185
1600000US0613014,Chico city,"Chico city, California",95016,428,45238,1681,49778,1731
1600000US0613077,Chilcoot-Vinton CDP,"Chilcoot-Vinton CDP, California",340,241,340,241,0,13
1600000US0613157,China Lake Acres CDP,"China Lake Acres CDP, California",2450,899,1084,450,1366,775
1600000US0613182,Chinese Camp CDP,"Chinese Camp CDP, California",146,130,130,141,16,25
1600000US0613210,Chino city,"Chino city, California",76753,924,47583,2271,29170,2186
1600000US0613214,Chino Hills city,"Chino Hills city, California",82675,167,61180,2325,21495,2319
1600000US0613278,Choctaw Valley CDP,"Choctaw Valley CDP, California",252,133,185,129,67,97
1600000US0613294,Chowchilla city,"Chowchilla city, California",11358,504,5896,818,5462,809
1600000US0613364,Chualar CDP,"Chualar CDP, California",1413,481,734,373,679,313
1600000US0613392,Chula Vista city,"Chula Vista city, California",266776,292,165103,4978,101673,4927
1600000US0613560,Citrus CDP,"Citrus CDP, California",10080,1062,6830,991,3250,804
1600000US0613588,Citrus Heights city,"Citrus Heights city, California",86987,154,51149,2076,35838,2079
1600000US0613756,Claremont city,"Claremont city, California",31352,489,22212,1163,9140,1036
1600000US0613784,Clarksburg CDP,"Clarksburg CDP, California",366,222,272,200,94,118
1600000US0613854,Clay CDP,"Clay CDP, California",1130,276,980,246,150,181
1600000US0613882,Clayton city,"Clayton city, California",11557,28,10299,526,1258,524
1600000US0613910,Clear Creek CDP,"Clear Creek CDP, California",293,139,173,112,120,96
1600000US0613945,Clearlake city,"Clearlake city, California",15155,81,8365,954,6790,949
1600000US0613966,Clearlake Oaks CDP,"Clearlake Oaks CDP, California",2194,419,1393,308,801,381
1600000US0613985,Clearlake Riviera CDP,"Clearlake Riviera CDP, California",4408,861,3298,936,1110,555
1600000US0614008,Cleone CDP,"Cleone CDP, California",841,282,817,285,24,39
1600000US0614106,Clio CDP,"Clio CDP, California",184,146,111,139,73,71
1600000US0614148,Clipper Mills CDP,"Clipper Mills CDP, California",451,375,153,160,298,421
1600000US0614190,Cloverdale city,"Cloverdale city, California",8786,73,5974,584,2812,595
1600000US0614218,Clovis city,"Clovis city, California",112151,185,74983,2359,37168,2350
1600000US0614232,Clyde CDP,"Clyde CDP, California",737,298,624,260,113,131
1600000US0614260,Coachella city,"Coachella city, California",45658,56,33482,1358,12176,1352
1600000US0614274,Coalinga city,"Coalinga city, California",13655,309,8676,818,4979,813
1600000US0614288,Coarsegold CDP,"Coarsegold CDP, California",4869,893,4460,927,409,307
1600000US0614302,Cobb CDP,"Cobb CDP, California",805,309,644,305,161,138
1600000US0614406,Coffee Creek CDP,"Coffee Creek CDP, California",177,69,153,64,24,24
1600000US0614442,Cohasset CDP,"Cohasset CDP, California",497,251,436,234,61,100
1600000US0614450,Cold Springs CDP (El Dorado County),"Cold Springs CDP (El Dorado County), California",675,259,493,271,182,146
1600000US0614454,Cold Springs CDP (Tuolumne County),"Cold Springs CDP (Tuolumne County), California",0,13,0,13,0,13
1600000US0614484,Coleville CDP,"Coleville CDP, California",353,159,28,32,325,153
1600000US0614498,Colfax city,"Colfax city, California",2258,460,1225,382,1033,289
1600000US0614554,College City CDP,"College City CDP, California",205,158,158,144,47,68
1600000US0614708,Collierville CDP,"Collierville CDP, California",2341,868,1717,807,624,437
1600000US0614736,Colma town,"Colma town, California",1492,273,728,213,764,225
1600000US0614764,Coloma CDP,"Coloma CDP, California",376,276,198,175,178,215
1600000US0614890,Colton city,"Colton city, California",53892,249,29029,1966,24863,1966
1600000US0614904,Columbia CDP,"Columbia CDP, California",1947,316,1405,305,542,232
1600000US0614946,Colusa city,"Colusa city, California",6046,36,3678,471,2368,468
1600000US0614974,Commerce city,"Commerce city, California",12649,88,7505,801,5144,794
1600000US0615030,Comptche CDP,"Comptche CDP, California",142,90,59,66,83,70
1600000US0615044,Compton city,"Compton city, California",95189,197,53653,2587,41536,2590
1600000US0616000,Concord city,"Concord city, California",127989,281,75747,2493,52242,2505
1600000US0616035,Concow CDP,"Concow CDP, California",472,95,340,92,132,80
1600000US0616090,Contra Costa Centre CDP,"Contra Costa Centre CDP, California",6662,682,1463,337,5199,695
1600000US0616210,Copperopolis CDP,"Copperopolis CDP, California",3566,589,3082,596,484,278
1600000US0616224,Corcoran city,"Corcoran city, California",13135,659,5794,742,7341,759
1600000US0616322,Corning city,"Corning city, California",7569,45,4628,701,2941,702
1600000US0616350,Corona city,"Corona city, California",167392,134,108912,3055,58480,3077
1600000US0616378,Coronado city,"Coronado city, California",20895,1694,10347,1027,10548,1223
1600000US0616420,Coronita CDP,"Coronita CDP, California",3945,769,3557,823,388,208
1600000US0616434,Corralitos CDP,"Corralitos CDP, California",2232,616,2057,599,175,131
1600000US0616462,Corte Madera town,"Corte Madera town, California",9793,19,6774,580,3019,581
1600000US0616532,Costa Mesa city,"Costa Mesa city, California",111036,317,46473,2049,64563,2059
1600000US0616560,Cotati city,"Cotati city, California",7469,52,4319,519,3150,511
1600000US0616580,Coto de Caza CDP,"Coto de Caza CDP, California",15509,1402,14173,1488,1336,409
1600000US0616623,Cottonwood CDP (Kern County),"Cottonwood CDP (Kern County), California",3121,736,692,359,2429,641
1600000US0616630,Cottonwood CDP (Shasta County),"Cottonwood CDP (Shasta County), California",5435,1133,4430,1065,1005,440
1600000US0616644,Coulterville CDP,"Coulterville CDP, California",23,44,0,13,23,44
1600000US0616651,Country Club CDP,"Country Club CDP, California",9227,937,5940,947,3287,689
1600000US0616714,Courtland CDP,"Courtland CDP, California",473,420,306,370,167,216
1600000US0616728,Covelo CDP,"Covelo CDP, California",1343,364,951,311,392,176
1600000US0616742,Covina city,"Covina city, California",47351,138,27850,1459,19501,1474
1600000US0616762,Cowan CDP,"Cowan CDP, California",472,427,202,179,270,394
1600000US0616886,Crane Creek CDP,"Crane Creek CDP, California",52,53,52,53,0,13
1600000US0617022,Crescent City city,"Crescent City city, California",4074,297,1541,513,2533,486
1600000US0617050,Crescent Mills CDP,"Crescent Mills CDP, California",70,51,51,56,19,22
1600000US0617078,Cressey CDP,"Cressey CDP, California",243,131,126,64,117,121
1600000US0617106,Crest CDP,"Crest CDP, California",2721,449,2474,436,247,155
1600000US0617162,Crestline CDP,"Crestline CDP, California",9292,1567,6078,884,3214,1374
1600000US0617232,Creston CDP,"Creston CDP, California",31,63,31,63,0,13
1600000US0617267,C-Road CDP,"C-Road CDP, California",90,70,45,46,45,54
1600000US0617274,Crockett CDP,"Crockett CDP, California",3205,393,1993,385,1212,312
1600000US0617288,Cromberg CDP,"Cromberg CDP, California",312,181,296,180,16,26
1600000US0617372,Crowley Lake CDP,"Crowley Lake CDP, California",1145,457,1015,436,130,125
1600000US0617428,Crows Landing CDP,"Crows Landing CDP, California",346,128,167,106,179,111
1600000US0617498,Cudahy city,"Cudahy city, California",23590,46,3621,717,19969,717
1600000US0617568,Culver City city,"Culver City city, California",38578,151,22211,1371,16367,1388
1600000US0617610,Cupertino city,"Cupertino city, California",59379,115,36002,1531,23377,1524
1600000US0617708,Cutler CDP,"Cutler CDP, California",5296,1139,2164,760,3132,1169
1600000US0617722,Cutten CDP,"Cutten CDP, California",3304,858,2338,656,966,615
1600000US0617727,Cuyama CDP,"Cuyama CDP, California",11,11,11,11,0,13
1600000US0617750,Cypress city,"Cypress city, California",48996,91,33935,1188,15061,1186
1600000US0617876,Dales CDP,"Dales CDP, California",0,13,0,13,0,13
1600000US0617918,Daly City city,"Daly City city, California",106371,136,65602,2241,40769,2227
1600000US0617946,Dana Point city,"Dana Point city, California",33646,62,20535,1339,13111,1339
1600000US0617988,Danville town,"Danville town, California",44809,80,38654,1065,6155,1065
1600000US0617995,Daphnedale Park CDP,"Daphnedale Park CDP, California",145,129,106,111,39,62
1600000US0618030,Darwin CDP,"Darwin CDP, California",90,65,90,65,0,13
1600000US0618086,Davenport CDP,"Davenport CDP, California",509,217,303,155,206,168
1600000US0618100,Davis city,"Davis city, California",66851,320,28954,1295,37897,1283
1600000US0618153,Day Valley CDP,"Day Valley CDP, California",3384,617,3128,613,256,190
1600000US0618324,Deer Park CDP,"Deer Park CDP, California",752,184,509,140,243,118
1600000US0618352,Del Aire CDP,"Del Aire CDP, California",10395,1235,7679,1197,2716,669
1600000US0618394,Delano city,"Delano city, California",44263,1134,26714,1927,17549,1860
1600000US0618422,Del Dios CDP,"Del Dios CDP, California",302,95,239,87,63,38
1600000US0618450,Delft Colony CDP,"Delft Colony CDP, California",1512,1101,823,1040,689,377
1600000US0618464,Delhi CDP,"Delhi CDP, California",11825,1395,8064,1221,3761,1056
1600000US0618485,Delleker CDP,"Delleker CDP, California",601,270,422,211,179,166
1600000US0618506,Del Mar city,"Del Mar city, California",4331,30,2514,500,1817,502
1600000US0618590,Del Monte Forest CDP,"Del Monte Forest CDP, California",3577,423,2946,375,631,295
1600000US0618674,Del Rey CDP,"Del Rey CDP, California",1246,384,555,204,691,324
1600000US0618688,Del Rey Oaks city,"Del Rey Oaks city, California",1518,221,1076,216,442,127
1600000US0618695,Del Rio CDP,"Del Rio CDP, California",1241,435,828,411,413,427
1600000US0618856,Denair CDP,"Denair CDP, California",5702,939,4082,744,1620,556
1600000US0618926,Derby Acres CDP,"Derby Acres CDP, California",288,74,198,59,90,53
1600000US0618940,Descanso CDP,"Descanso CDP, California",1398,356,1296,336,102,108
1600000US0618982,Desert Center CDP,"Desert Center CDP, California",272,143,222,134,50,56
1600000US0618986,Desert Edge CDP,"Desert Edge CDP, California",3480,632,3110,603,370,172
1600000US0618996,Desert Hot Springs city,"Desert Hot Springs city, California",29123,116,14464,1613,14659,1637
1600000US0619022,Desert Palms CDP,"Desert Palms CDP, California",6599,962,5531,832,1068,657
1600000US0619024,Desert Shores CDP,"Desert Shores CDP, California",411,216,262,141,149,190
1600000US0619052,Desert View Highlands CDP,"Desert View Highlands CDP, California",3259,913,1655,498,1604,876
1600000US0619150,Diablo CDP,"Diablo CDP, California",834,552,834,552,0,13
1600000US0619155,Diablo Grande CDP,"Diablo Grande CDP, California",892,221,842,223,50,52
1600000US0619192,Diamond Bar city,"Diamond Bar city, California",55670,86,41775,1407,13895,1418
1600000US0619220,Diamond Springs CDP,"Diamond Springs CDP, California",11195,1138,8122,916,3073,902
1600000US0619248,Di Giorgio CDP,"Di Giorgio CDP, California",398,150,99,73,299,139
1600000US0619262,Dillon Beach CDP,"Dillon Beach CDP, California",309,158,174,101,135,125
1600000US0619318,Dinuba city,"Dinuba city, California",24246,113,12369,1323,11877,1328
1600000US0619339,Discovery Bay CDP,"Discovery Bay CDP, California",15853,1059,12974,1066,2879,960
1600000US0619402,Dixon city,"Dixon city, California",20083,49,11883,1085,8200,1080
1600000US0619406,Dixon Lane-MeadowCreek CDP,"Dixon Lane-MeadowCreek CDP, California",2755,332,2557,358,198,168
1600000US0619416,Dobbins CDP,"Dobbins CDP, California",130,140,130,140,0,13
1600000US0619440,Dogtown CDP,"Dogtown CDP, California",3006,600,2352,526,654,294
1600000US0619455,Dollar Point CDP,"Dollar Point CDP, California",909,280,601,227,308,198
1600000US0619570,Dorrington CDP,"Dorrington CDP, California",404,162,385,160,19,19
1600000US0619584,Dorris city,"Dorris city, California",867,189,604,172,263,116
1600000US0619612,Dos Palos city,"Dos Palos city, California",5239,29,3238,714,2001,716
1600000US0619654,Dos Palos Y CDP,"Dos Palos Y CDP, California",206,120,71,44,135,115
1600000US0619724,Douglas City CDP,"Douglas City CDP, California",678,208,480,160,198,145
1600000US0619766,Downey city,"Downey city, California",110575,190,56924,2104,53651,2100
1600000US0619794,Downieville CDP,"Downieville CDP, California",99,92,89,91,10,16
1600000US0619878,Doyle CDP,"Doyle CDP, California",745,303,684,303,61,64
1600000US0619976,Drytown CDP,"Drytown CDP, California",13,18,13,18,0,13
1600000US0619990,Duarte city,"Duarte city, California",21073,157,14175,1007,6898,1011
1600000US0620018,Dublin city,"Dublin city, California",62487,217,41886,1506,20601,1489
1600000US0620032,Ducor CDP,"Ducor CDP, California",708,277,658,279,50,37
1600000US0620228,Dunnigan CDP,"Dunnigan CDP, California",1391,340,915,308,476,255
1600000US0620242,Dunsmuir city,"Dunsmuir city, California",1870,234,1038,213,832,254
1600000US0620270,Durham CDP,"Durham CDP, California",6213,1101,4013,899,2200,970
1600000US0620284,Dustin Acres CDP,"Dustin Acres CDP, California",568,181,421,154,147,120
1600000US0620298,Dutch Flat CDP,"Dutch Flat CDP, California",133,52,96,48,37,34
1600000US0620424,Eagleville CDP,"Eagleville CDP, California",15,17,15,17,0,13
1600000US0620438,Earlimart CDP,"Earlimart CDP, California",8908,1256,5817,1223,3091,696
1600000US0620515,East Bakersfield CDP,"East Bakersfield CDP, California",10065,1706,2260,620,7805,1677
1600000US0620574,Eastern Goleta Valley CDP,"Eastern Goleta Valley CDP, California",28623,1578,21035,1484,7588,1158
1600000US0620598,East Foothills CDP,"East Foothills CDP, California",6745,842,5800,888,945,353
1600000US0620697,East Hemet CDP,"East Hemet CDP, California",20021,1882,11206,1444,8815,1461
1600000US0620802,East Los Angeles CDP,"East Los Angeles CDP, California",120296,3810,44238,2603,76058,3366
1600000US0620900,East Nicolaus CDP,"East Nicolaus CDP, California",172,54,92,35,80,58
1600000US0620903,East Niles CDP,"East Niles CDP, California",29703,2239,17870,1836,11833,2454
1600000US0620907,East Oakdale CDP,"East Oakdale CDP, California",2370,358,2309,346,61,78
1600000US0620928,Easton CDP,"Easton CDP, California",2224,393,1380,334,844,334
1600000US0620942,East Orosi CDP,"East Orosi CDP, California",624,309,210,182,414,311
1600000US0620956,East Palo Alto city,"East Palo Alto city, California",29271,158,14209,1457,15062,1465
1600000US0620984,East Pasadena CDP,"East Pasadena CDP, California",6003,610,4151,618,1852,388
1600000US0621012,East Porterville CDP,"East Porterville CDP, California",5383,1110,3099,922,2284,680
1600000US0621026,East Quincy CDP,"East Quincy CDP, California",2232,486,1310,340,922,461
1600000US0621034,East Rancho Dominguez CDP,"East Rancho Dominguez CDP, California",15171,1683,8990,1539,6181,868
1600000US0621061,East Richmond Heights CDP,"East Richmond Heights CDP, California",3468,447,2684,418,784,291
1600000US0621096,East San Gabriel CDP,"East San Gabriel CDP, California",22952,1255,13869,1332,9083,1053
1600000US0621138,East Shore CDP,"East Shore CDP, California",139,100,139,100,0,13
1600000US0621188,East Sonora CDP,"East Sonora CDP, California",2486,468,1845,492,641,251
1600000US0621210,East Tulare Villa CDP,"East Tulare Villa CDP, California",849,281,452,148,397,245
1600000US0621230,Eastvale city,"Eastvale city, California",65748,55,51641,2054,14107,2057
1600000US0621292,East Whittier CDP,"East Whittier CDP, California",10161,744,6583,682,3578,777
1600000US0621530,Edgewood CDP,"Edgewood CDP, California",39,33,20,12,19,34
1600000US0621544,Edison CDP,"Edison CDP, California",109,117,64,95,45,63
1600000US0621558,Edmundson Acres CDP,"Edmundson Acres CDP, California",341,162,242,140,99,76
1600000US0621565,Edna CDP,"Edna CDP, California",408,327,343,314,65,89
1600000US0621600,Edwards AFB CDP,"Edwards AFB CDP, California",2512,392,0,13,2512,392
1600000US0621691,El Adobe CDP,"El Adobe CDP, California",118,106,85,104,33,45
1600000US0621712,El Cajon city,"El Cajon city, California",100850,375,41033,2236,59817,2127
1600000US0621782,El Centro city,"El Centro city, California",43436,174,23041,1484,20395,1535
1600000US0621788,El Centro Naval Air Facility CDP,"El Centro Naval Air Facility CDP, California",244,172,0,13,244,172
1600000US0621796,El Cerrito city,"El Cerrito city, California",25151,79,14218,757,10933,746
1600000US0621810,El Cerrito CDP,"El Cerrito CDP, California",5251,998,4089,898,1162,480
1600000US0621880,El Dorado Hills CDP,"El Dorado Hills CDP, California",47091,1496,40799,1513,6292,985
1600000US0621894,Eldridge CDP,"Eldridge CDP, California",954,293,499,270,455,241
1600000US0621916,Elfin Forest CDP,"Elfin Forest CDP, California",455,192,455,192,0,13
1600000US0621936,El Granada CDP,"El Granada CDP, California",6048,931,5348,911,700,341
1600000US0621964,Elizabeth Lake CDP,"Elizabeth Lake CDP, California",1632,252,1301,246,331,158
1600000US0622006,Elk Creek CDP,"Elk Creek CDP, California",175,113,45,38,130,110
1600000US0622020,Elk Grove city,"Elk Grove city, California",172518,215,127692,3341,44826,3303
1600000US0622034,Elkhorn CDP,"Elkhorn CDP, California",998,305,784,258,214,162
1600000US0622104,El Macero CDP,"El Macero CDP, California",1086,253,1046,253,40,41
1600000US0622146,Elmira CDP,"Elmira CDP, California",234,148,36,41,198,158
1600000US0622230,El Monte city,"El Monte city, California",112590,259,47082,2415,65508,2405
1600000US0622235,El Monte Mobile Village CDP,"El Monte Mobile Village CDP, California",0,13,0,13,0,13
1600000US0622286,El Nido CDP,"El Nido CDP, California",283,134,93,80,190,113
1600000US0622300,El Paso de Robles (Paso Robles) city,"El Paso de Robles (Paso Robles) city, California",31363,52,18686,1452,12677,1450
1600000US0622328,El Portal CDP,"El Portal CDP, California",271,176,116,94,155,150
1600000US0622360,El Rancho CDP,"El Rancho CDP, California",0,13,0,13,0,13
1600000US0622370,El Rio CDP,"El Rio CDP, California",6496,944,3179,637,3317,927
1600000US0622412,El Segundo city,"El Segundo city, California",16540,50,8114,768,8426,777
1600000US0622454,El Sobrante CDP (Contra Costa County),"El Sobrante CDP (Contra Costa County), California",14727,1427,9709,1312,5018,1006
1600000US0622457,El Sobrante CDP (Riverside County),"El Sobrante CDP (Riverside County), California",13063,1343,11980,1360,1083,686
1600000US0622510,El Verano CDP,"El Verano CDP, California",3236,670,1845,501,1391,585
1600000US0622524,Elverta CDP,"Elverta CDP, California",5227,665,4229,688,998,409
1600000US0622587,Emerald Lake Hills CDP,"Emerald Lake Hills CDP, California",4842,518,4498,527,344,181
1600000US0622594,Emeryville city,"Emeryville city, California",11674,24,3228,389,8446,388
1600000US0622622,Empire CDP,"Empire CDP, California",3150,391,1731,401,1419,420
1600000US0622678,Encinitas city,"Encinitas city, California",62620,117,41458,1841,21162,1855
1600000US0622790,Escalon city,"Escalon city, California",7531,26,4921,644,2610,646
1600000US0622804,Escondido city,"Escondido city, California",148041,440,77141,3195,70900,3233
1600000US0622846,Esparto CDP,"Esparto CDP, California",4009,859,2829,814,1180,524
1600000US0622972,Etna city,"Etna city, California",740,183,441,136,299,148
1600000US0623000,Eucalyptus Hills CDP,"Eucalyptus Hills CDP, California",6435,1452,5351,1396,1084,534
1600000US0623042,Eureka city,"Eureka city, California",25704,234,12071,1122,13633,1050
1600000US0623126,Exeter city,"Exeter city, California",10355,92,6085,894,4270,886
1600000US0623150,Fairbanks Ranch CDP,"Fairbanks Ranch CDP, California",2929,1186,2208,1051,721,793
1600000US0623158,Fairfax CDP,"Fairfax CDP, California",1778,380,1439,495,339,321
1600000US0623168,Fairfax town,"Fairfax town, California",7595,35,4855,572,2740,573
1600000US0623182,Fairfield city,"Fairfield city, California",114798,312,68782,2907,46016,2885
1600000US0623196,Fairhaven CDP,"Fairhaven CDP, California",240,96,139,71,101,66
1600000US0623210,Fairmead CDP,"Fairmead CDP, California",1133,363,989,382,144,65
1600000US0623294,Fair Oaks CDP,"Fair Oaks CDP, California",30246,1503,21610,1474,8636,1079
1600000US0623350,Fairview CDP,"Fairview CDP, California",10649,845,9047,755,1602,451
1600000US0623462,Fallbrook CDP,"Fallbrook CDP, California",32178,2347,18957,1859,13221,1648
1600000US0623532,Fall River Mills CDP,"Fall River Mills CDP, California",345,216,122,114,223,182
1600000US0623616,Farmersville city,"Farmersville city, California",10842,28,7499,812,3343,820
1600000US0623630,Farmington CDP,"Farmington CDP, California",169,125,59,74,110,107
1600000US0623812,Fellows CDP,"Fellows CDP, California",54,35,48,36,6,7
1600000US0623826,Felton CDP,"Felton CDP, California",3197,482,2533,451,664,262
1600000US0623910,Ferndale city,"Ferndale city, California",1387,246,809,187,578,199
1600000US0623973,Fetters Hot Springs-Agua Caliente CDP,"Fetters Hot Springs-Agua Caliente CDP, California",3528,541,1952,445,1576,393
1600000US0623980,Fiddletown CDP,"Fiddletown CDP, California",211,139,143,114,68,85
1600000US0624008,Fieldbrook CDP,"Fieldbrook CDP, California",793,129,707,123,86,48
1600000US0624022,Fields Landing CDP,"Fields Landing CDP, California",577,585,130,207,447,644
1600000US0624092,Fillmore city,"Fillmore city, California",15437,68,10060,1032,5377,1034
1600000US0624134,Firebaugh city,"Firebaugh city, California",7746,28,3483,685,4263,689
1600000US0624218,Fish Camp CDP,"Fish Camp CDP, California",50,57,50,57,0,13
1600000US0624477,Florence-Graham CDP,"Florence-Graham CDP, California",64709,2706,25496,2606,39213,2306
1600000US0624498,Florin CDP,"Florin CDP, California",48365,2369,26022,1899,22343,2542
1600000US0624526,Floriston CDP,"Floriston CDP, California",28,28,28,28,0,13
1600000US0624568,Flournoy CDP,"Flournoy CDP, California",161,66,142,65,19,29
1600000US0624638,Folsom city,"Folsom city, California",74555,487,53882,1676,20673,1656
1600000US0624680,Fontana city,"Fontana city, California",212148,287,141795,3935,70353,3934
1600000US0624722,Foothill Farms CDP,"Foothill Farms CDP, California",35634,1782,17160,1353,18474,1652
1600000US0624750,Forbestown CDP,"Forbestown CDP, California",369,218,326,245,43,50
1600000US0624764,Ford City CDP,"Ford City CDP, California",4909,773,1936,503,2973,653
1600000US0624834,Foresthill CDP,"Foresthill CDP, California",1545,538,1095,527,450,317
1600000US0624897,Forest Meadows CDP,"Forest Meadows CDP, California",1324,405,1059,351,265,231
1600000US0624918,Forest Ranch CDP,"Forest Ranch CDP, California",1551,807,1551,807,0,13
1600000US0624960,Forestville CDP,"Forestville CDP, California",3741,671,2779,477,962,492
1600000US0625030,Fort Bidwell CDP,"Fort Bidwell CDP, California",174,78,70,41,104,64
1600000US0625058,Fort Bragg city,"Fort Bragg city, California",7092,207,2545,401,4547,453
1600000US0625086,Fort Dick CDP,"Fort Dick CDP, California",1405,352,1272,349,133,123
1600000US0625093,Fort Hunter Liggett CDP,"Fort Hunter Liggett CDP, California",95,147,0,13,95,147
1600000US0625114,Fort Irwin CDP,"Fort Irwin CDP, California",7920,959,20,65,7900,962
1600000US0625128,Fort Jones city,"Fort Jones city, California",578,140,298,104,280,123
1600000US0625296,Fortuna city,"Fortuna city, California",11992,77,6829,567,5163,564
1600000US0625300,Fort Washington CDP,"Fort Washington CDP, California",215,168,215,168,0,13
1600000US0625338,Foster City city,"Foster City city, California",32879,78,17618,932,15261,924
1600000US0625380,Fountain Valley city,"Fountain Valley city, California",55609,157,37659,1501,17950,1487
1600000US0625436,Fowler city,"Fowler city, California",6318,68,3451,558,2867,565
1600000US0625488,Franklin CDP (Merced County),"Franklin CDP (Merced County), California",7709,1215,5075,1156,2634,1000
1600000US0625506,Franklin CDP (Sacramento County),"Franklin CDP (Sacramento County), California",26,31,16,25,10,20
1600000US0625534,Frazier Park CDP,"Frazier Park CDP, California",3121,1036,2159,1041,962,437
1600000US0625576,Freedom CDP,"Freedom CDP, California",3959,948,2526,733,1433,763
1600000US0625590,Freeport CDP,"Freeport CDP, California",70,65,0,13,70,65
1600000US0626000,Fremont city,"Fremont city, California",233351,267,143718,3406,89633,3426
1600000US0626028,French Camp CDP,"French Camp CDP, California",1223,428,524,175,699,418
1600000US0626056,French Gulch CDP,"French Gulch CDP, California",441,96,357,98,84,35
1600000US0626067,French Valley CDP,"French Valley CDP, California",37818,2696,29740,2907,8078,1926
1600000US0627000,Fresno city,"Fresno city, California",516558,747,247700,5282,268858,5319
1600000US0627014,Friant CDP,"Friant CDP, California",541,157,313,119,228,150
1600000US0627080,Fruitdale CDP,"Fruitdale CDP, California",1114,445,897,447,217,130
1600000US0627130,Fruitridge Pocket CDP,"Fruitridge Pocket CDP, California",5562,954,2010,613,3552,802
1600000US0627190,Fuller Acres CDP,"Fuller Acres CDP, California",634,276,338,232,296,162
1600000US0628000,Fullerton city,"Fullerton city, California",137618,347,72492,3040,65126,3032
1600000US0628014,Fulton CDP,"Fulton CDP, California",413,312,250,217,163,261
1600000US0628021,Furnace Creek CDP,"Furnace Creek CDP, California",88,53,34,40,54,34
1600000US0628112,Galt city,"Galt city, California",26065,75,19410,1011,6655,1018
1600000US0628154,Garberville CDP,"Garberville CDP, California",1361,449,551,338,810,304
1600000US0628168,Gardena city,"Gardena city, California",58657,168,29447,1862,29210,1867
1600000US0628182,Garden Acres CDP,"Garden Acres CDP, California",10091,1169,4943,803,5148,1116
1600000US0628210,Garden Farms CDP,"Garden Farms CDP, California",418,241,297,205,121,165
1600000US0629000,Garden Grove city,"Garden Grove city, California",170795,321,92216,2846,78579,2891
1600000US0629070,Garey CDP,"Garey CDP, California",47,24,37,21,10,18
1600000US0629112,Garnet CDP,"Garnet CDP, California",5559,1860,4660,1861,899,320
1600000US0629154,Gasquet CDP,"Gasquet CDP, California",608,235,477,225,131,83
1600000US0629252,Gazelle CDP,"Gazelle CDP, California",111,54,63,34,48,41
1600000US0629350,Georgetown CDP,"Georgetown CDP, California",2827,926,2394,870,433,326
1600000US0629392,Gerber CDP,"Gerber CDP, California",1084,322,560,262,524,242
1600000US0629420,Geyserville CDP,"Geyserville CDP, California",671,165,407,129,264,136
1600000US0629504,Gilroy city,"Gilroy city, California",54815,201,35480,1702,19335,1672
1600000US0630000,Glendale city,"Glendale city, California",197554,304,71890,2685,125664,2733
1600000US0630014,Glendora city,"Glendora city, California",50098,255,35177,1450,14921,1409
1600000US0630028,Glen Ellen CDP,"Glen Ellen CDP, California",1214,886,1134,877,80,109
1600000US0630126,Glennville CDP,"Glennville CDP, California",54,41,26,25,28,32
1600000US0630282,Golden Hills CDP,"Golden Hills CDP, California",10229,1285,8074,1437,2155,667
1600000US0630339,Gold Mountain CDP,"Gold Mountain CDP, California",75,100,0,13,75,100
1600000US0630345,Gold River CDP,"Gold River CDP, California",7930,748,7223,784,707,248
1600000US0630378,Goleta city,"Goleta city, California",31907,151,17266,1304,14641,1312
1600000US0630392,Gonzales city,"Gonzales city, California",8340,27,4928,697,3412,698
1600000US0630410,Good Hope CDP,"Good Hope CDP, California",8407,1558,4168,1142,4239,1061
1600000US0630412,Goodmanville CDP,"Goodmanville CDP, California",84,104,84,104,0,13
1600000US0630420,Goodyears Bar CDP,"Goodyears Bar CDP, California",80,85,22,33,58,78
1600000US0630476,Goshen CDP,"Goshen CDP, California",5387,1133,3718,832,1669,927
1600000US0630560,Graeagle CDP,"Graeagle CDP, California",552,218,466,180,86,107
1600000US0630658,Grand Terrace city,"Grand Terrace city, California",12418,106,8397,740,4021,718
1600000US0630686,Grangeville CDP,"Grangeville CDP, California",324,213,295,208,29,39
1600000US0630693,Granite Bay CDP,"Granite Bay CDP, California",22739,1348,21035,1384,1704,506
1600000US0630703,Granite Hills CDP,"Granite Hills CDP, California",4009,864,3542,858,467,436
1600000US0630714,Graniteville CDP,"Graniteville CDP, California",14,22,14,22,0,13
1600000US0630798,Grass Valley city,"Grass Valley city, California",12206,222,4548,617,7658,628
1600000US0630812,Graton CDP,"Graton CDP, California",1722,490,1331,531,391,278
1600000US0630882,Grayson CDP,"Grayson CDP, California",1582,479,748,379,834,425
1600000US0630900,Greeley Hill CDP,"Greeley Hill CDP, California",919,230,754,229,165,112
1600000US0630938,Greenacres CDP,"Greenacres CDP, California",5247,771,3956,802,1291,583
1600000US0630944,Green Acres CDP,"Green Acres CDP, California",3845,1596,3067,1493,778,555
1600000US0630987,Greenfield CDP,"Greenfield CDP, California",3777,1188,2076,827,1701,975
1600000US0630994,Greenfield city,"Greenfield city, California",17514,33,8744,1067,8770,1070
1600000US0631029,Greenhorn CDP,"Greenhorn CDP, California",202,57,124,53,78,21
1600000US0631092,Green Valley CDP (Los Angeles County),"Green Valley CDP (Los Angeles County), California",1096,176,799,173,297,159
1600000US0631099,Green Valley CDP (Solano County),"Green Valley CDP (Solano County), California",1583,322,1452,313,131,153
1600000US0631134,Greenview CDP,"Greenview CDP, California",139,118,52,71,87,106
1600000US0631162,Greenville CDP,"Greenville CDP, California",785,260,577,215,208,171
1600000US0631246,Grenada CDP,"Grenada CDP, California",295,131,98,72,197,107
1600000US0631260,Gridley city,"Gridley city, California",7065,75,3514,807,3551,799
1600000US0631288,Grimes CDP,"Grimes CDP, California",462,245,165,143,297,211
1600000US0631302,Grizzly Flats CDP,"Grizzly Flats CDP, California",1382,741,1221,726,161,258
1600000US0631372,Groveland CDP,"Groveland CDP, California",249,115,239,119,10,16
1600000US0631393,Grover Beach city,"Grover Beach city, California",13447,37,6415,883,7032,883
1600000US0631414,Guadalupe city,"Guadalupe city, California",7654,19,3381,671,4273,672
1600000US0631470,Guerneville CDP,"Guerneville CDP, California",4747,538,3167,423,1580,473
1600000US0631540,Guinda CDP,"Guinda CDP, California",113,99,59,49,54,87
1600000US0631568,Gustine city,"Gustine city, California",5748,15,2769,845,2979,844
1600000US0631596,Hacienda Heights CDP,"Hacienda Heights CDP, California",55205,1930,42235,2037,12970,1366
1600000US0631708,Half Moon Bay city,"Half Moon Bay city, California",12583,28,7959,775,4624,775
1600000US0631883,Hamilton Branch CDP,"Hamilton Branch CDP, California",446,130,403,112,43,40
1600000US0631890,Hamilton City CDP,"Hamilton City CDP, California",2446,442,1297,370,1149,435
1600000US0631960,Hanford city,"Hanford city, California",56868,129,33808,2083,23060,2077
1600000US0632030,Happy Camp CDP,"Happy Camp CDP, California",845,178,451,135,394,138
1600000US0632036,Happy Valley CDP,"Happy Valley CDP, California",5633,1023,4560,1044,1073,644
1600000US0632044,Harbison Canyon CDP,"Harbison Canyon CDP, California",4352,575,4056,567,296,155
1600000US0632156,Hardwick CDP,"Hardwick CDP, California",152,113,45,55,107,106
1600000US0632212,Harmony Grove CDP,"Harmony Grove CDP, California",1494,563,1083,491,411,371
1600000US0632324,Hartland CDP,"Hartland CDP, California",0,13,0,13,0,13
1600000US0632340,Hartley CDP,"Hartley CDP, California",2650,475,2301,479,349,205
1600000US0632385,Hasley Canyon CDP,"Hasley Canyon CDP, California",1433,453,1307,452,126,133
1600000US0632408,Hat Creek CDP,"Hat Creek CDP, California",77,49,77,49,0,13
1600000US0632506,Hawaiian Gardens city,"Hawaiian Gardens city, California",14189,31,6068,833,8121,836
1600000US0632548,Hawthorne city,"Hawthorne city, California",84744,174,25235,1959,59509,1971
1600000US0632562,Hayfork CDP,"Hayfork CDP, California",2561,437,1266,359,1295,475
1600000US0633000,Hayward city,"Hayward city, California",155303,408,86598,2720,68705,2687
1600000US0633056,Healdsburg city,"Healdsburg city, California",11863,35,6234,882,5629,880
1600000US0633084,Heber CDP,"Heber CDP, California",8413,1199,5253,1262,3160,1039
1600000US0633182,Hemet city,"Hemet city, California",83903,212,50757,2390,33146,2365
1600000US0633294,Herald CDP,"Herald CDP, California",986,258,866,241,120,96
1600000US0633308,Hercules city,"Hercules city, California",26025,56,20742,1051,5283,1042
1600000US0633336,Herlong CDP,"Herlong CDP, California",315,134,0,13,315,134
1600000US0633364,Hermosa Beach city,"Hermosa Beach city, California",19142,24,10381,779,8761,778
1600000US0633434,Hesperia city,"Hesperia city, California",95010,103,58792,2780,36218,2771
1600000US0633504,Hickman CDP,"Hickman CDP, California",751,225,548,158,203,158
1600000US0633518,Hidden Hills city,"Hidden Hills city, California",2218,429,1953,445,265,200
1600000US0633532,Hidden Meadows CDP,"Hidden Meadows CDP, California",3663,634,3281,625,382,287
1600000US0633549,Hidden Valley Lake CDP,"Hidden Valley Lake CDP, California",5948,662,4035,670,1913,627
1600000US0633574,Highgrove CDP,"Highgrove CDP, California",6192,1088,4059,931,2133,882
1600000US0633588,Highland city,"Highland city, California",55184,119,36232,1722,18952,1723
1600000US0633632,Highlands CDP,"Highlands CDP, California",2810,390,2416,381,394,142
1600000US0633689,Hillcrest CDP,"Hillcrest CDP, California",11747,1315,5851,1030,5896,1143
1600000US0633798,Hillsborough town,"Hillsborough town, California",11608,31,10992,270,616,275
1600000US0633861,Hilmar-Irwin CDP,"Hilmar-Irwin CDP, California",5937,1089,3817,1062,2120,616
1600000US0633935,Hiouchi CDP,"Hiouchi CDP, California",266,84,266,84,0,13
1600000US0634120,Hollister city,"Hollister city, California",39982,144,24912,1643,15070,1639
1600000US0634246,Holtville city,"Holtville city, California",6129,24,3180,886,2949,890
1600000US0634281,Home Garden CDP,"Home Garden CDP, California",1590,361,800,250,790,346
1600000US0634302,Home Gardens CDP,"Home Gardens CDP, California",12014,923,8701,837,3313,657
1600000US0634316,Homeland CDP,"Homeland CDP, California",7598,1661,5604,1591,1994,589
1600000US0634392,Homestead Valley CDP,"Homestead Valley CDP, California",2619,448,1953,393,666,268
1600000US0634405,Homewood Canyon CDP,"Homewood Canyon CDP, California",241,164,232,164,9,15
1600000US0634428,Honcut CDP,"Honcut CDP, California",172,150,98,129,74,89
1600000US0634484,Hood CDP,"Hood CDP, California",289,272,239,276,50,51
1600000US0634540,Hoopa CDP,"Hoopa CDP, California",3319,650,2315,639,1004,329
1600000US0634652,Hopland CDP,"Hopland CDP, California",899,248,373,136,526,230
1600000US0634694,Hornbrook CDP,"Hornbrook CDP, California",243,71,141,57,102,54
1600000US0634708,Hornitos CDP,"Hornitos CDP, California",74,96,74,96,0,13
1600000US0634904,Hughson city,"Hughson city, California",7541,19,5211,664,2330,666
1600000US0634928,Humboldt Hill CDP,"Humboldt Hill CDP, California",3193,458,2504,452,689,267
1600000US0636000,Huntington Beach city,"Huntington Beach city, California",198780,282,113458,2854,85322,2845
1600000US0636056,Huntington Park city,"Huntington Park city, California",57615,68,17152,1313,40463,1318
1600000US0636084,Huron city,"Huron city, California",7084,26,1589,571,5495,569
1600000US0636098,Hyampom CDP,"Hyampom CDP, California",124,104,79,118,45,68
1600000US0636126,Hydesville CDP,"Hydesville CDP, California",1051,248,936,257,115,64
1600000US0636135,Hypericum CDP,"Hypericum CDP, California",160,163,133,157,27,43
1600000US0636168,Idlewild CDP,"Idlewild CDP, California",0,13,0,13,0,13
1600000US0636203,Idyllwild-Pine Cove CDP,"Idyllwild-Pine Cove CDP, California",2955,595,1917,372,1038,479
1600000US0636252,Igo CDP,"Igo CDP, California",148,121,148,121,0,13
1600000US0636280,Imperial city,"Imperial city, California",18601,54,13479,1575,5122,1577
1600000US0636294,Imperial Beach city,"Imperial Beach city, California",26312,331,7818,963,18494,980
1600000US0636350,Independence CDP,"Independence CDP, California",692,185,525,179,167,61
1600000US0636364,Indian Falls CDP,"Indian Falls CDP, California",10,17,10,17,0,13
1600000US0636420,Indianola CDP,"Indianola CDP, California",660,180,432,143,228,121
1600000US0636434,Indian Wells city,"Indian Wells city, California",5454,56,4493,495,961,489
1600000US0636448,Indio city,"Indio city, California",89070,288,64759,2399,24311,2337
1600000US0636452,Indio Hills CDP,"Indio Hills CDP, California",801,563,781,572,20,32
1600000US0636490,Industry city,"Industry city, California",249,90,26,17,223,89
1600000US0636546,Inglewood city,"Inglewood city, California",107254,866,41223,2088,66031,2233
1600000US0636613,Interlaken CDP,"Interlaken CDP, California",7392,942,5186,1017,2206,1040
1600000US0636616,Inverness CDP,"Inverness CDP, California",1497,286,1200,279,297,142
1600000US0636658,Inyokern CDP,"Inyokern CDP, California",645,296,445,273,200,140
1600000US0636672,Ione city,"Ione city, California",7351,125,5826,648,1525,652
1600000US0636735,Iron Horse CDP,"Iron Horse CDP, California",290,197,290,197,0,13
1600000US0636770,Irvine city,"Irvine city, California",265079,579,124744,4105,140335,4035
1600000US0636826,Irwindale city,"Irwindale city, California",1365,172,1104,181,261,104
1600000US0636868,Isla Vista CDP,"Isla Vista CDP, California",14286,1181,67,56,14219,1193
1600000US0636882,Isleton city,"Isleton city, California",495,125,298,97,197,88
1600000US0636910,Ivanhoe CDP,"Ivanhoe CDP, California",4584,1240,1973,530,2611,1166
1600000US0636980,Jackson city,"Jackson city, California",4637,94,2555,404,2082,403
1600000US0637022,Jacumba CDP,"Jacumba CDP, California",579,484,189,143,390,464
1600000US0637106,Jamestown CDP,"Jamestown CDP, California",3379,600,2057,522,1322,465
1600000US0637120,Jamul CDP,"Jamul CDP, California",5754,1051,5258,1021,496,218
1600000US0637134,Janesville CDP,"Janesville CDP, California",2790,423,1947,304,843,369
1600000US0637274,Jenner CDP,"Jenner CDP, California",31,34,15,23,16,25
1600000US0637400,Johannesburg CDP,"Johannesburg CDP, California",48,53,23,34,25,42
1600000US0637442,Johnson Park CDP,"Johnson Park CDP, California",815,505,331,183,484,491
1600000US0637484,Johnstonville CDP,"Johnstonville CDP, California",1151,228,982,213,169,117
1600000US0637512,Johnsville CDP,"Johnsville CDP, California",0,13,0,13,0,13
1600000US0637533,Jones Valley CDP,"Jones Valley CDP, California",1269,289,1022,253,247,139
1600000US0637554,Joshua Tree CDP,"Joshua Tree CDP, California",7644,1230,3976,1085,3668,765
1600000US0637568,Jovista CDP,"Jovista CDP, California",93,99,84,99,9,13
1600000US0637582,Julian CDP,"Julian CDP, California",1318,410,1103,390,215,153
1600000US0637596,Junction City CDP,"Junction City CDP, California",744,177,690,181,54,32
1600000US0637624,June Lake CDP,"June Lake CDP, California",413,208,369,194,44,69
1600000US0637692,Jurupa Valley city,"Jurupa Valley city, California",105793,196,75151,2347,30642,2347
1600000US0637904,Keddie CDP,"Keddie CDP, California",68,67,30,45,38,49
1600000US0637918,Keeler CDP,"Keeler CDP, California",6,9,6,9,0,13
1600000US0637946,Keene CDP,"Keene CDP, California",257,140,216,123,41,67
1600000US0638024,Kelly Ridge CDP,"Kelly Ridge CDP, California",2932,532,2446,522,486,238
1600000US0638044,Kelseyville CDP,"Kelseyville CDP, California",3657,624,1599,504,2058,561
1600000US0638065,Kennedy CDP,"Kennedy CDP, California",2838,622,1535,507,1303,578
1600000US0638076,Kennedy Meadows CDP,"Kennedy Meadows CDP, California",143,220,143,220,0,13
1600000US0638086,Kensington CDP,"Kensington CDP, California",5163,554,4384,555,779,272
1600000US0638114,Kentfield CDP,"Kentfield CDP, California",7396,612,6197,581,1199,384
1600000US0638156,Kenwood CDP,"Kenwood CDP, California",530,209,488,205,42,42
1600000US0638177,Kep'el CDP,"Kep'el CDP, California",26,19,15,12,11,12
1600000US0638226,Kerman city,"Kerman city, California",14909,23,7939,1215,6970,1217
1600000US0638310,Kernville CDP,"Kernville CDP, California",774,465,531,426,243,266
1600000US0638352,Keswick CDP,"Keswick CDP, California",192,138,64,67,128,116
1600000US0638394,Kettleman City CDP,"Kettleman City CDP, California",1245,401,349,196,896,402
1600000US0638422,Keyes CDP,"Keyes CDP, California",5691,1312,3318,789,2373,1074
1600000US0638520,King City city,"King City city, California",13787,33,4681,870,9106,870
1600000US0638548,Kings Beach CDP,"Kings Beach CDP, California",2826,675,1701,578,1125,460
1600000US0638562,Kingsburg city,"Kingsburg city, California",12028,53,8721,759,3307,756
1600000US0638604,Kingvale CDP,"Kingvale CDP, California",102,108,102,108,0,13
1600000US0638646,Kirkwood CDP,"Kirkwood CDP, California",121,99,109,97,12,16
1600000US0638702,Klamath CDP,"Klamath CDP, California",964,136,656,133,308,80
1600000US0638772,Knightsen CDP,"Knightsen CDP, California",1100,419,928,406,172,184
1600000US0638786,Knights Ferry CDP,"Knights Ferry CDP, California",62,39,53,39,9,11
1600000US0638800,Knights Landing CDP,"Knights Landing CDP, California",981,382,629,330,352,220
1600000US0639003,La Cañada Flintridge city,"La Cañada Flintridge city, California",20032,75,17640,530,2392,520
1600000US0639045,La Crescenta-Montrose CDP,"La Crescenta-Montrose CDP, California",20166,1316,13744,1217,6422,1125
1600000US0639052,La Cresta CDP,"La Cresta CDP, California",9964,1421,3721,1126,6243,1282
1600000US0639094,Ladera CDP,"Ladera CDP, California",1385,320,1385,320,0,13
1600000US0639108,Ladera Heights CDP,"Ladera Heights CDP, California",6404,1075,5116,1039,1288,383
1600000US0639114,Ladera Ranch CDP,"Ladera Ranch CDP, California",24996,1342,18338,1208,6658,995
1600000US0639122,Lafayette city,"Lafayette city, California",25829,59,19480,923,6349,927
1600000US0639164,La Grange CDP,"La Grange CDP, California",143,79,38,27,105,75
1600000US0639178,Laguna Beach city,"Laguna Beach city, California",22930,73,15440,1141,7490,1138
1600000US0639220,Laguna Hills city,"Laguna Hills city, California",31143,141,22400,1291,8743,1326
1600000US0639248,Laguna Niguel city,"Laguna Niguel city, California",64691,115,43409,1580,21282,1600
1600000US0639259,Laguna Woods city,"Laguna Woods city, California",15999,57,11509,540,4490,532
1600000US0639283,Lagunitas-Forest Knolls CDP,"Lagunitas-Forest Knolls CDP, California",1860,509,1181,376,679,401
1600000US0639290,La Habra city,"La Habra city, California",62331,268,35243,1538,27088,1491
1600000US0639304,La Habra Heights city,"La Habra Heights city, California",5293,52,4664,348,629,348
1600000US0639318,La Honda CDP,"La Honda CDP, California",1215,408,906,361,309,210
1600000US0639411,Lake Almanor Country Club CDP,"Lake Almanor Country Club CDP, California",429,161,333,127,96,91
1600000US0639420,Lake Almanor Peninsula CDP,"Lake Almanor Peninsula CDP, California",382,114,365,113,17,18
1600000US0639425,Lake Almanor West CDP,"Lake Almanor West CDP, California",329,176,290,163,39,58
1600000US0639444,Lake Arrowhead CDP,"Lake Arrowhead CDP, California",9699,1253,7165,1177,2534,607
1600000US0639460,Lake California CDP,"Lake California CDP, California",3276,758,1957,593,1319,560
1600000US0639472,Lake City CDP,"Lake City CDP, California",86,61,84,61,2,4
1600000US0639483,Lake Davis CDP,"Lake Davis CDP, California",91,58,80,56,11,17
1600000US0639484,Lake Don Pedro CDP,"Lake Don Pedro CDP, California",1465,338,1279,322,186,164
1600000US0639486,Lake Elsinore city,"Lake Elsinore city, California",64182,66,45289,1652,18893,1642
1600000US0639496,Lake Forest city,"Lake Forest city, California",84111,220,60201,1904,23910,1876
1600000US0639514,Lakehead CDP,"Lakehead CDP, California",615,167,501,161,114,91
1600000US0639556,Lake Hughes CDP,"Lake Hughes CDP, California",660,376,565,358,95,123
1600000US0639570,Lake Isabella CDP,"Lake Isabella CDP, California",3621,1039,1559,505,2062,956
1600000US0639598,Lakeland Village CDP,"Lakeland Village CDP, California",12357,2334,7229,1554,5128,1528
1600000US0639612,Lake Los Angeles CDP,"Lake Los Angeles CDP, California",11880,1388,7811,1171,4069,1041
1600000US0639645,Lake Mathews CDP,"Lake Mathews CDP, California",7359,1269,6033,1169,1326,575
1600000US0639670,Lake Nacimiento CDP,"Lake Nacimiento CDP, California",3021,422,2574,415,447,226
1600000US0639690,Lake of the Pines CDP,"Lake of the Pines CDP, California",4350,668,3721,693,629,333
1600000US0639696,Lake of the Woods CDP,"Lake of the Woods CDP, California",757,271,540,236,217,143
1600000US0639710,Lakeport city,"Lakeport city, California",4810,78,3578,353,1232,347
1600000US0639715,Lake Riverside CDP,"Lake Riverside CDP, California",1139,379,1139,379,0,13
1600000US0639724,Lake San Marcos CDP,"Lake San Marcos CDP, California",3957,621,2976,532,981,418
1600000US0639728,Lake Shastina CDP,"Lake Shastina CDP, California",2790,341,2117,331,673,228
1600000US0639735,Lake Sherwood CDP,"Lake Sherwood CDP, California",1697,301,1369,304,328,170
1600000US0639759,Lakeside CDP (Kern County),"Lakeside CDP (Kern County), California",969,383,893,357,76,106
1600000US0639766,Lakeside CDP (San Diego County),"Lakeside CDP (San Diego County), California",20818,1843,14263,1601,6555,1244
1600000US0639836,Lakeview CDP,"Lakeview CDP, California",2447,784,1543,765,904,499
1600000US0639885,Lake Wildwood CDP,"Lake Wildwood CDP, California",4704,386,3636,421,1068,420
1600000US0639892,Lakewood city,"Lakewood city, California",79550,80,58827,1614,20723,1628
1600000US0640004,La Mesa city,"La Mesa city, California",59433,177,26934,2184,32499,2194
1600000US0640032,La Mirada city,"La Mirada city, California",45341,328,36150,1276,9191,1231
1600000US0640088,Lamont CDP,"Lamont CDP, California",14724,1423,6674,1230,8050,1066
1600000US0640116,Lanare CDP,"Lanare CDP, California",241,227,102,146,139,183
1600000US0640130,Lancaster city,"Lancaster city, California",150783,434,82678,3203,68105,3199
1600000US0640256,La Palma city,"La Palma city, California",15613,52,10340,756,5273,761
1600000US0640312,La Porte CDP,"La Porte CDP, California",0,13,0,13,0,13
1600000US0640326,La Presa CDP,"La Presa CDP, California",37073,1940,24486,2106,12587,1414
1600000US0640340,La Puente city,"La Puente city, California",39691,58,23534,1382,16157,1382
1600000US0640354,La Quinta city,"La Quinta city, California",41578,60,29364,1364,12214,1379
1600000US0640410,La Riviera CDP,"La Riviera CDP, California",11470,1345,6523,1203,4947,770
1600000US0640426,Larkfield-Wikiup CDP,"Larkfield-Wikiup CDP, California",8026,1014,4902,794,3124,732
1600000US0640438,Larkspur city,"Larkspur city, California",12235,55,7024,480,5211,478
1600000US0640508,La Selva Beach CDP,"La Selva Beach CDP, California",2519,406,1351,283,1168,450
1600000US0640526,Las Flores CDP (Orange County),"Las Flores CDP (Orange County), California",5089,876,3876,598,1213,692
1600000US0640536,Las Flores CDP (Tehama County),"Las Flores CDP (Tehama County), California",217,184,26,28,191,191
1600000US0640592,Las Lomas CDP,"Las Lomas CDP, California",3818,954,2050,869,1768,599
1600000US0640704,Lathrop city,"Lathrop city, California",23841,43,18750,1055,5091,1055
1600000US0640746,Laton CDP,"Laton CDP, California",1967,523,1005,409,962,353
1600000US0640830,La Verne city,"La Verne city, California",31610,166,24282,924,7328,880
1600000US0640872,La Vina CDP,"La Vina CDP, California",203,256,203,256,0,13
1600000US0640886,Lawndale city,"Lawndale city, California",32389,71,13107,1513,19282,1525
1600000US0640928,Laytonville CDP,"Laytonville CDP, California",777,197,337,133,440,163
1600000US0640956,Lebec CDP,"Lebec CDP, California",1474,526,1051,478,423,295
1600000US0640998,Lee Vining CDP,"Lee Vining CDP, California",46,61,0,13,46,61
1600000US0641026,Leggett CDP,"Leggett CDP, California",56,40,47,39,9,7
1600000US0641040,Le Grand CDP,"Le Grand CDP, California",1597,277,997,229,600,203
1600000US0641110,Lemon Cove CDP,"Lemon Cove CDP, California",263,157,240,158,23,23
1600000US0641124,Lemon Grove city,"Lemon Grove city, California",26537,123,14989,1091,11548,1084
1600000US0641142,Lemon Hill CDP,"Lemon Hill CDP, California",15065,1864,4761,895,10304,1726
1600000US0641152,Lemoore city,"Lemoore city, California",25852,67,14544,1175,11308,1173
1600000US0641166,Lemoore Station CDP,"Lemoore Station CDP, California",4853,629,0,19,4853,629
1600000US0641180,Lennox CDP,"Lennox CDP, California",22471,1378,7023,1189,15448,1245
1600000US0641194,Lenwood CDP,"Lenwood CDP, California",4431,1104,1951,770,2480,807
1600000US0641208,Leona Valley CDP,"Leona Valley CDP, California",1672,311,1585,307,87,73
1600000US0641278,Lewiston CDP,"Lewiston CDP, California",1478,343,1080,329,398,200
1600000US0641282,Lexington Hills CDP,"Lexington Hills CDP, California",2643,378,2493,385,150,108
1600000US0641390,Likely CDP,"Likely CDP, California",0,13,0,13,0,13
1600000US0641474,Lincoln city,"Lincoln city, California",47998,127,38645,1345,9353,1344
1600000US0641558,Lincoln Village CDP,"Lincoln Village CDP, California",3980,724,2387,520,1593,480
1600000US0641572,Linda CDP,"Linda CDP, California",21808,1322,10649,1371,11159,1410
1600000US0641656,Lindcove CDP,"Lindcove CDP, California",73,53,73,53,0,13
1600000US0641670,Linden CDP,"Linden CDP, California",2043,592,1447,391,596,509
1600000US0641712,Lindsay city,"Lindsay city, California",12701,57,7034,975,5667,987
1600000US0641740,Linnell Camp CDP,"Linnell Camp CDP, California",837,445,0,13,837,445
1600000US0641782,Litchfield CDP,"Litchfield CDP, California",183,111,155,105,28,46
1600000US0641789,Little Grass Valley CDP,"Little Grass Valley CDP, California",0,13,0,13,0,13
1600000US0641866,Little River CDP,"Little River CDP, California",176,139,77,70,99,130
1600000US0641880,Littlerock CDP,"Littlerock CDP, California",948,566,495,300,453,466
1600000US0641908,Little Valley CDP,"Little Valley CDP, California",19,22,8,15,11,16
1600000US0641922,Live Oak CDP,"Live Oak CDP, California",15873,1161,9491,879,6382,1048
1600000US0641936,Live Oak city,"Live Oak city, California",8677,46,5235,632,3442,629
1600000US0641992,Livermore city,"Livermore city, California",91339,97,67099,1906,24240,1887
1600000US0642006,Livingston city,"Livingston city, California",14386,31,8886,1209,5500,1213
1600000US0642104,Lockeford CDP,"Lockeford CDP, California",3555,624,2544,499,1011,476
1600000US0642142,Lockwood CDP (Amador County),"Lockwood CDP (Amador County), California",451,229,444,229,7,11
1600000US0642146,Lockwood CDP (Monterey County),"Lockwood CDP (Monterey County), California",351,176,177,108,174,162
1600000US0642202,Lodi city,"Lodi city, California",65861,207,34112,1471,31749,1439
1600000US0642230,Lodoga CDP,"Lodoga CDP, California",184,111,86,53,98,99
1600000US0642328,Loleta CDP,"Loleta CDP, California",599,220,330,155,269,144
1600000US0642370,Loma Linda city,"Loma Linda city, California",23046,377,9950,1233,13096,1235
1600000US0642384,Loma Mar CDP,"Loma Mar CDP, California",282,204,183,173,99,141
1600000US0642412,Loma Rica CDP,"Loma Rica CDP, California",2909,765,2315,733,594,330
1600000US0642468,Lomita city,"Lomita city, California",20029,94,9122,900,10907,881
1600000US0642510,Lompico CDP,"Lompico CDP, California",881,197,778,206,103,95
1600000US0642524,Lompoc city,"Lompoc city, California",39636,402,17316,1584,22320,1640
1600000US0642566,London CDP,"London CDP, California",1534,305,331,109,1203,299
1600000US0642580,Lone Pine CDP,"Lone Pine CDP, California",1436,269,829,233,607,174
1600000US0642622,Long Barn CDP,"Long Barn CDP, California",88,97,0,13,88,97
1600000US0643000,Long Beach city,"Long Beach city, California",452816,865,190197,4245,262619,4130
1600000US0643126,Lookout CDP,"Lookout CDP, California",50,44,22,18,28,40
1600000US0643140,Loomis town,"Loomis town, California",6767,45,5183,486,1584,482
1600000US0643224,Los Alamitos city,"Los Alamitos city, California",11334,106,4975,523,6359,539
1600000US0643252,Los Alamos CDP,"Los Alamos CDP, California",1254,370,883,284,371,323
1600000US0643280,Los Altos city,"Los Altos city, California",30593,111,24949,712,5644,702
1600000US0643294,Los Altos Hills town,"Los Altos Hills town, California",8417,70,7612,363,805,350
1600000US0644000,Los Angeles city,"Los Angeles city, California",3883012,2746,1576486,14833,2306526,14692
1600000US0644028,Los Banos city,"Los Banos city, California",39304,74,22239,1772,17065,1780
1600000US0644042,Los Berros CDP,"Los Berros CDP, California",296,177,296,177,0,13
1600000US0644112,Los Gatos town,"Los Gatos town, California",31548,299,22350,959,9198,936
1600000US0644140,Los Molinos CDP,"Los Molinos CDP, California",1924,487,989,332,935,484
1600000US0644168,Los Olivos CDP,"Los Olivos CDP, California",838,188,629,172,209,112
1600000US0644182,Los Osos CDP,"Los Osos CDP, California",16041,1213,11404,1049,4637,782
1600000US0644242,Los Ranchos CDP,"Los Ranchos CDP, California",1675,440,1502,445,173,204
1600000US0644280,Lost Hills CDP,"Lost Hills CDP, California",1742,272,678,206,1064,236
1600000US0644350,Lower Lake CDP,"Lower Lake CDP, California",1060,298,638,255,422,260
1600000US0644364,Loyalton city,"Loyalton city, California",1037,214,666,178,371,164
1600000US0644378,Loyola CDP,"Loyola CDP, California",3404,309,3090,300,314,170
1600000US0644399,Lucas Valley-Marinwood CDP,"Lucas Valley-Marinwood CDP, California",6627,589,5840,740,787,433
1600000US0644406,Lucerne CDP,"Lucerne CDP, California",2674,591,1890,426,784,480
1600000US0644420,Lucerne Valley CDP,"Lucerne Valley CDP, California",5632,1063,3759,978,1873,600
1600000US0644574,Lynwood city,"Lynwood city, California",66617,771,34317,2152,32300,2009
1600000US0644644,Lytle Creek CDP,"Lytle Creek CDP, California",644,145,475,108,169,113
1600000US0644672,Mabie CDP,"Mabie CDP, California",72,105,72,105,0,13
1600000US0644700,McArthur CDP,"McArthur CDP, California",521,307,246,218,275,289
1600000US0644760,McClellan Park CDP,"McClellan Park CDP, California",747,253,0,13,747,253
1600000US0644770,McClenney Tract CDP,"McClenney Tract CDP, California",38,35,18,29,20,22
1600000US0644784,McCloud CDP,"McCloud CDP, California",894,198,586,161,308,150
1600000US0644812,Macdoel CDP,"Macdoel CDP, California",26,37,0,13,26,37
1600000US0644826,McFarland city,"McFarland city, California",12000,206,6452,787,5548,804
1600000US0644830,McGee Creek CDP,"McGee Creek CDP, California",0,13,0,13,0,13
1600000US0644910,McKinleyville CDP,"McKinleyville CDP, California",16640,1272,11538,1319,5102,886
1600000US0644924,McKittrick CDP,"McKittrick CDP, California",130,50,83,39,47,28
1600000US0645006,McSwain CDP,"McSwain CDP, California",4429,767,3865,597,564,442
1600000US0645008,Madeline CDP,"Madeline CDP, California",11,17,11,17,0,13
1600000US0645022,Madera city,"Madera city, California",64709,226,31146,2300,33563,2280
1600000US0645050,Madera Acres CDP,"Madera Acres CDP, California",9973,1387,9086,1412,887,595
1600000US0645054,Madera Ranchos CDP,"Madera Ranchos CDP, California",3584,777,3011,604,573,424
1600000US0645064,Madison CDP,"Madison CDP, California",497,272,344,249,153,134
1600000US0645092,Mad River CDP,"Mad River CDP, California",341,128,258,100,83,82
1600000US0645120,Magalia CDP,"Magalia CDP, California",11425,1129,8688,955,2737,898
1600000US0645232,Malaga CDP,"Malaga CDP, California",1168,282,515,213,653,257
1600000US0645246,Malibu city,"Malibu city, California",12179,67,9795,667,2384,664
1600000US0645358,Mammoth Lakes town,"Mammoth Lakes town, California",8110,104,4389,640,3721,627
1600000US0645386,Manchester CDP,"Manchester CDP, California",267,183,108,76,159,182
1600000US0645400,Manhattan Beach city,"Manhattan Beach city, California",35038,65,25729,1160,9309,1164
1600000US0645414,Manila CDP,"Manila CDP, California",754,186,305,102,449,203
1600000US0645484,Manteca city,"Manteca city, California",80456,180,54018,1797,26438,1769
1600000US0645512,Manton CDP,"Manton CDP, California",320,225,231,222,89,83
1600000US0645680,March ARB CDP,"March ARB CDP, California",1174,381,8,13,1166,380
1600000US0645736,Maricopa city,"Maricopa city, California",2157,47,1135,238,1022,240
1600000US0645778,Marina city,"Marina city, California",20966,288,8675,889,12291,877
1600000US0645806,Marina del Rey CDP,"Marina del Rey CDP, California",10065,1702,362,182,9703,1703
1600000US0645820,Marin City CDP,"Marin City CDP, California",3040,453,959,338,2081,340
1600000US0645932,Mariposa CDP,"Mariposa CDP, California",1093,265,612,239,481,159
1600000US0645988,Markleeville CDP,"Markleeville CDP, California",187,100,142,68,45,64
1600000US0646100,Martell CDP,"Martell CDP, California",113,80,48,53,65,64
1600000US0646114,Martinez city,"Martinez city, California",37816,192,27082,996,10734,983
1600000US0646170,Marysville city,"Marysville city, California",11864,167,6680,813,5184,806
1600000US0646223,Matheny CDP,"Matheny CDP, California",1036,270,342,119,694,256
1600000US0646226,Mather CDP,"Mather CDP, California",4301,517,3752,542,549,205
1600000US0646338,Maxwell CDP,"Maxwell CDP, California",1256,340,742,303,514,214
1600000US0646400,Mayfair CDP,"Mayfair CDP, California",4856,993,2030,615,2826,773
1600000US0646436,Mayflower Village CDP,"Mayflower Village CDP, California",5682,714,4206,659,1476,470
1600000US0646492,Maywood city,"Maywood city, California",27000,83,7886,1192,19114,1167
1600000US0646520,Meadowbrook CDP,"Meadowbrook CDP, California",4199,977,2432,608,1767,952
1600000US0646618,Meadow Valley CDP,"Meadow Valley CDP, California",478,171,478,171,0,13
1600000US0646632,Meadow Vista CDP,"Meadow Vista CDP, California",3508,523,3033,436,475,312
1600000US0646646,Mead Valley CDP,"Mead Valley CDP, California",20583,2517,15981,2406,4602,1413
1600000US0646660,Mecca CDP,"Mecca CDP, California",5541,1056,3491,766,2050,784
1600000US0646702,Meiners Oaks CDP,"Meiners Oaks CDP, California",3697,796,2295,590,1402,565
1600000US0646814,Mendocino CDP,"Mendocino CDP, California",639,261,325,179,314,209
1600000US0646828,Mendota city,"Mendota city, California",12173,23,6303,888,5870,888
1600000US0646842,Menifee city,"Menifee city, California",92797,105,73906,2077,18891,2070
1600000US0646870,Menlo Park city,"Menlo Park city, California",34106,388,21441,1190,12665,1132
1600000US0646884,Mentone CDP,"Mentone CDP, California",10055,1342,6944,1176,3111,598
1600000US0646898,Merced city,"Merced city, California",82992,315,34148,2276,48844,2289
1600000US0646926,Meridian CDP,"Meridian CDP, California",278,76,186,63,92,43
1600000US0647013,Mesa CDP,"Mesa CDP, California",434,132,385,138,49,44
1600000US0647066,Mesa Verde CDP,"Mesa Verde CDP, California",753,249,676,238,77,77
1600000US0647086,Mesa Vista CDP,"Mesa Vista CDP, California",211,64,205,64,6,8
1600000US0647164,Mettler CDP,"Mettler CDP, California",115,64,52,38,63,57
1600000US0647192,Mexican Colony CDP,"Mexican Colony CDP, California",337,127,117,58,220,120
1600000US0647206,Meyers CDP,"Meyers CDP, California",2288,369,1871,354,417,175
1600000US0647332,Middletown CDP,"Middletown CDP, California",725,450,242,220,483,417
1600000US0647374,Midpines CDP,"Midpines CDP, California",309,183,193,130,116,119
1600000US0647430,Midway City CDP,"Midway City CDP, California",8631,1359,2529,577,6102,1374
1600000US0647472,Milford CDP,"Milford CDP, California",117,170,117,170,0,13
1600000US0647486,Millbrae city,"Millbrae city, California",22756,107,14246,826,8510,818
1600000US0647592,Millerton CDP,"Millerton CDP, California",679,506,679,506,0,13
1600000US0647710,Mill Valley city,"Mill Valley city, California",14385,60,10012,774,4373,767
1600000US0647724,Millville CDP,"Millville CDP, California",879,290,642,267,237,133
1600000US0647766,Milpitas city,"Milpitas city, California",72748,362,46328,1852,26420,1871
1600000US0647794,Mineral CDP,"Mineral CDP, California",250,182,100,76,150,167
1600000US0647822,Minkler CDP,"Minkler CDP, California",968,335,927,322,41,80
1600000US0648046,Mira Monte CDP,"Mira Monte CDP, California",6760,1178,5827,1215,933,424
1600000US0648060,Miranda CDP,"Miranda CDP, California",490,303,222,195,268,256
1600000US0648147,Mission Canyon CDP,"Mission Canyon CDP, California",2649,465,2192,392,457,261
1600000US0648186,Mission Hills CDP,"Mission Hills CDP, California",3509,645,2459,362,1050,600
1600000US0648256,Mission Viejo city,"Mission Viejo city, California",94036,410,72272,2276,21764,2249
1600000US0648298,Mi-Wuk Village CDP,"Mi-Wuk Village CDP, California",933,348,735,324,198,205
1600000US0648354,Modesto city,"Modesto city, California",211775,643,117174,3677,94601,3675
1600000US0648410,Modjeska CDP,"Modjeska CDP, California",821,318,702,319,119,92
1600000US0648448,Mohawk Vista CDP,"Mohawk Vista CDP, California",53,49,43,47,10,15
1600000US0648452,Mojave CDP,"Mojave CDP, California",3780,690,1218,372,2562,676
1600000US0648480,Mokelumne Hill CDP,"Mokelumne Hill CDP, California",484,317,451,312,33,52
1600000US0648592,Monmouth CDP,"Monmouth CDP, California",113,92,92,91,21,20
1600000US0648602,Mono City CDP,"Mono City CDP, California",135,115,56,93,79,120
1600000US0648641,Mono Vista CDP,"Mono Vista CDP, California",3574,615,2756,546,818,557
1600000US0648648,Monrovia city,"Monrovia city, California",37423,210,16956,1493,20467,1481
1600000US0648676,Monson CDP,"Monson CDP, California",210,215,173,205,37,60
1600000US0648690,Montague city,"Montague city, California",1491,271,907,217,584,205
1600000US0648718,Montalvin Manor CDP,"Montalvin Manor CDP, California",2478,439,1531,428,947,371
1600000US0648760,Montara CDP,"Montara CDP, California",2833,1000,2489,988,344,352
1600000US0648788,Montclair city,"Montclair city, California",39724,226,21801,1907,17923,1932
1600000US0648816,Montebello city,"Montebello city, California",62232,174,26963,1565,35269,1562
1600000US0648844,Montecito CDP,"Montecito CDP, California",7128,789,5153,634,1975,441
1600000US0648872,Monterey city,"Monterey city, California",26021,422,8732,920,17289,913
1600000US0648914,Monterey Park city,"Monterey Park city, California",60342,115,30348,1575,29994,1589
1600000US0648916,Monterey Park Tract CDP,"Monterey Park Tract CDP, California",293,334,69,96,224,320
1600000US0648928,Monte Rio CDP,"Monte Rio CDP, California",1023,339,704,298,319,142
1600000US0648956,Monte Sereno city,"Monte Sereno city, California",3511,23,3361,94,150,86
1600000US0648998,Montgomery Creek CDP,"Montgomery Creek CDP, California",98,76,85,74,13,17
1600000US0649045,Monument Hills CDP,"Monument Hills CDP, California",1354,336,1257,307,97,163
1600000US0649138,Moorpark city,"Moorpark city, California",36443,40,29018,1041,7425,1043
1600000US0649180,Morada CDP,"Morada CDP, California",3384,633,3172,643,212,155
1600000US0649187,Moraga town,"Moraga town, California",14984,294,12295,656,2689,652
1600000US0649270,Moreno Valley city,"Moreno Valley city, California",207990,155,130769,3809,77221,3836
1600000US0649278,Morgan Hill city,"Morgan Hill city, California",44354,218,31199,1294,13155,1271
1600000US0649348,Morongo Valley CDP,"Morongo Valley CDP, California",3164,529,2436,326,728,453
1600000US0649362,Morro Bay city,"Morro Bay city, California",10445,82,6462,655,3983,645
1600000US0649432,Moskowite Corner CDP,"Moskowite Corner CDP, California",69,48,64,45,5,11
1600000US0649446,Moss Beach CDP,"Moss Beach CDP, California",3307,573,2743,676,564,391
1600000US0649488,Moss Landing CDP,"Moss Landing CDP, California",25,40,25,40,0,13
1600000US0649544,Mountain Center CDP,"Mountain Center CDP, California",17,26,0,13,17,26
1600000US0649558,Mountain Gate CDP,"Mountain Gate CDP, California",703,245,499,162,204,201
1600000US0649582,Mountain House CDP,"Mountain House CDP, California",21387,2119,16146,2111,5241,1236
1600000US0649592,Mountain Meadows CDP,"Mountain Meadows CDP, California",251,217,251,217,0,13
1600000US0649600,Mountain Mesa CDP,"Mountain Mesa CDP, California",954,295,856,251,98,140
1600000US0649628,Mountain Ranch CDP,"Mountain Ranch CDP, California",318,336,285,335,33,37
1600000US0649651,Mountain View CDP,"Mountain View CDP, California",1830,499,1146,447,684,327
1600000US0649670,Mountain View city,"Mountain View city, California",79814,100,35148,1591,44666,1595
1600000US0649684,Mountain View Acres CDP,"Mountain View Acres CDP, California",3684,772,2657,762,1027,509
1600000US0649726,Mt. Bullion CDP,"Mt. Bullion CDP, California",105,59,92,55,13,21
1600000US0649768,Mount Hebron CDP,"Mount Hebron CDP, California",61,76,12,19,49,73
1600000US0649796,Mount Hermon CDP,"Mount Hermon CDP, California",1394,513,968,342,426,415
1600000US0649810,Mount Laguna CDP,"Mount Laguna CDP, California",102,167,102,167,0,13
1600000US0649852,Mount Shasta city,"Mount Shasta city, California",3243,27,1373,294,1870,293
1600000US0649950,Muir Beach CDP,"Muir Beach CDP, California",360,115,323,116,37,27
1600000US0650034,Murphys CDP,"Murphys CDP, California",1944,425,1446,372,498,222
1600000US0650076,Murrieta city,"Murrieta city, California",113480,195,77418,3102,36062,3076
1600000US0650132,Muscoy CDP,"Muscoy CDP, California",11194,1552,6866,1330,4328,1133
1600000US0650146,Myers Flat CDP,"Myers Flat CDP, California",126,198,126,198,0,13
1600000US0650188,Myrtletown CDP,"Myrtletown CDP, California",4850,716,2073,681,2777,674
1600000US0650258,Napa city,"Napa city, California",77305,185,44209,1780,33096,1809
1600000US0650398,National City city,"National City city, California",55100,1255,21441,1395,33659,1607
1600000US0650734,Needles city,"Needles city, California",4959,38,2901,487,2058,486
1600000US0650874,Nevada City city,"Nevada City city, California",2875,98,1123,317,1752,322
1600000US0650916,Newark city,"Newark city, California",48007,70,31692,1534,16315,1529
1600000US0651000,Newcastle CDP,"Newcastle CDP, California",1349,350,1286,349,63,53
1600000US0651028,New Cuyama CDP,"New Cuyama CDP, California",550,183,431,173,119,72
1600000US0651042,Newell CDP,"Newell CDP, California",481,173,348,161,133,119
1600000US0651140,Newman city,"Newman city, California",11434,51,8232,877,3202,877
1600000US0651168,New Pine Creek CDP,"New Pine Creek CDP, California",47,52,47,52,0,13
1600000US0651182,Newport Beach city,"Newport Beach city, California",86217,204,50962,1990,35255,2001
1600000US0651280,Nicasio CDP,"Nicasio CDP, California",123,58,121,57,2,4
1600000US0651294,Nice CDP,"Nice CDP, California",2384,632,1483,474,901,532
1600000US0651336,Nicolaus CDP,"Nicolaus CDP, California",124,42,73,30,51,34
1600000US0651392,Niland CDP,"Niland CDP, California",743,421,381,301,362,339
1600000US0651470,Nipinnawasee CDP,"Nipinnawasee CDP, California",388,203,312,224,76,98
1600000US0651476,Nipomo CDP,"Nipomo CDP, California",18163,1564,12485,1476,5678,1348
1600000US0651560,Norco city,"Norco city, California",23945,234,19966,837,3979,815
1600000US0651574,Nord CDP,"Nord CDP, California",368,236,236,199,132,204
1600000US0651622,Norris Canyon CDP,"Norris Canyon CDP, California",790,229,773,233,17,31
1600000US0651637,North Auburn CDP,"North Auburn CDP, California",13555,1361,8321,1195,5234,1029
1600000US0651812,North Edwards CDP,"North Edwards CDP, California",906,275,521,172,385,238
1600000US0651820,North El Monte CDP,"North El Monte CDP, California",3654,725,2415,681,1239,413
1600000US0651840,North Fair Oaks CDP,"North Fair Oaks CDP, California",14903,1571,8309,1578,6594,879
1600000US0651868,North Fork CDP,"North Fork CDP, California",3306,542,2471,555,835,306
1600000US0651890,North Gate CDP,"North Gate CDP, California",740,234,647,205,93,138
1600000US0651924,North Highlands CDP,"North Highlands CDP, California",48361,2478,22495,2117,25866,2488
1600000US0651990,North Lakeport CDP,"North Lakeport CDP, California",3067,482,2050,411,1017,367
1600000US0652162,North Richmond CDP,"North Richmond CDP, California",4258,732,2780,686,1478,463
1600000US0652246,North San Juan CDP,"North San Juan CDP, California",151,85,94,60,57,65
1600000US0652302,North Shore CDP,"North Shore CDP, California",2580,839,2528,848,52,64
1600000US0652379,North Tustin CDP,"North Tustin CDP, California",24917,1629,22349,1503,2568,688
1600000US0652526,Norwalk city,"Norwalk city, California",101902,619,68868,2200,33034,2137
1600000US0652582,Novato city,"Novato city, California",53123,336,35970,1791,17153,1789
1600000US0652610,Nubieber CDP,"Nubieber CDP, California",31,32,25,34,6,11
1600000US0652624,Nuevo CDP,"Nuevo CDP, California",6999,929,4815,905,2184,737
1600000US0652694,Oakdale city,"Oakdale city, California",22709,88,15106,1212,7603,1199
1600000US0652715,Oak Glen CDP,"Oak Glen CDP, California",267,169,243,171,24,28
1600000US0652760,Oak Hills CDP,"Oak Hills CDP, California",10415,1749,8806,1875,1609,715
1600000US0652764,Oakhurst CDP,"Oakhurst CDP, California",5397,644,3613,586,1784,629
1600000US0653000,Oakland city,"Oakland city, California",415937,578,182929,4113,233008,4087
1600000US0653070,Oakley city,"Oakley city, California",41554,70,30822,1838,10732,1847
1600000US0653116,Oak Park CDP,"Oak Park CDP, California",13982,1339,9796,1390,4186,740
1600000US0653140,Oak Run CDP,"Oak Run CDP, California",371,364,355,364,16,21
1600000US0653160,Oak Shores CDP,"Oak Shores CDP, California",325,140,306,136,19,29
1600000US0653182,Oak View CDP,"Oak View CDP, California",6541,750,4874,694,1667,591
1600000US0653196,Oakville CDP,"Oakville CDP, California",74,116,0,13,74,116
1600000US0653224,Oasis CDP,"Oasis CDP, California",2549,495,1774,367,775,515
1600000US0653266,Occidental CDP,"Occidental CDP, California",876,288,625,266,251,160
1600000US0653294,Oceano CDP,"Oceano CDP, California",7601,988,4537,908,3064,811
1600000US0653322,Oceanside city,"Oceanside city, California",174939,211,99323,2965,75616,2994
1600000US0653378,Ocotillo CDP,"Ocotillo CDP, California",44,50,18,30,26,42
1600000US0653448,Oildale CDP,"Oildale CDP, California",35501,2905,11169,1456,24332,2975
1600000US0653476,Ojai city,"Ojai city, California",7362,173,4547,552,2815,545
1600000US0653490,Olancha CDP,"Olancha CDP, California",181,96,181,96,0,13
1600000US0653503,Olde Stockdale CDP,"Olde Stockdale CDP, California",839,328,784,317,55,87
1600000US0653505,Old Fig Garden CDP,"Old Fig Garden CDP, California",5594,858,4727,813,867,336
1600000US0653574,Old River CDP,"Old River CDP, California",76,254,76,254,0,13
1600000US0653602,Old Station CDP,"Old Station CDP, California",21,31,21,31,0,13
1600000US0653603,Old Stine CDP,"Old Stine CDP, California",3381,556,2094,524,1287,376
1600000US0653714,Olivehurst CDP,"Olivehurst CDP, California",15076,1232,10328,1304,4748,880
1600000US0653882,Ono CDP,"Ono CDP, California",57,37,57,37,0,13
1600000US0653896,Ontario city,"Ontario city, California",177433,266,97432,3630,80001,3604
1600000US0653910,Onyx CDP,"Onyx CDP, California",576,299,471,247,105,168
1600000US0653980,Orange city,"Orange city, California",131820,550,77242,2391,54578,2461
1600000US0653987,Orange Blossom CDP,"Orange Blossom CDP, California",1155,315,699,221,456,250
1600000US0654008,Orange Cove city,"Orange Cove city, California",10120,30,4151,735,5969,732
1600000US0654092,Orangevale CDP,"Orangevale CDP, California",34755,1920,25863,1756,8892,1101
1600000US0654120,Orcutt CDP,"Orcutt CDP, California",31199,1681,23616,2078,7583,1293
1600000US0654218,Orick CDP,"Orick CDP, California",346,107,123,68,223,91
1600000US0654232,Orinda city,"Orinda city, California",19415,39,18212,409,1203,408
1600000US0654274,Orland city,"Orland city, California",7833,25,4138,769,3695,765
1600000US0654372,Orosi CDP,"Orosi CDP, California",8908,1803,5039,1344,3869,1659
1600000US0654386,Oroville city,"Oroville city, California",17978,392,8381,901,9597,868
1600000US0654388,Oroville East CDP,"Oroville East CDP, California",8078,784,6803,793,1275,413
1600000US0654652,Oxnard city,"Oxnard city, California",206207,478,109507,3940,96700,3929
1600000US0654764,Pacheco CDP,"Pacheco CDP, California",4775,924,3550,886,1225,443
1600000US0654806,Pacifica city,"Pacifica city, California",38476,83,27899,1089,10577,1092
1600000US0654848,Pacific Grove city,"Pacific Grove city, California",15217,108,7273,545,7944,530
1600000US0655044,Pajaro CDP,"Pajaro CDP, California",3402,667,677,407,2725,559
1600000US0655048,Pajaro Dunes CDP,"Pajaro Dunes CDP, California",235,132,93,57,142,137
1600000US0655058,Pala CDP,"Pala CDP, California",1094,217,678,154,416,124
1600000US0655086,Palermo CDP,"Palermo CDP, California",5204,631,3702,582,1502,466
1600000US0655156,Palmdale city,"Palmdale city, California",153009,74,98650,2756,54359,2754
1600000US0655184,Palm Desert city,"Palm Desert city, California",52797,120,33365,1537,19432,1530
1600000US0655254,Palm Springs city,"Palm Springs city, California",47888,135,28951,956,18937,965
1600000US0655282,Palo Alto city,"Palo Alto city, California",67430,137,40129,1672,27301,1680
1600000US0655296,Palo Cedro CDP,"Palo Cedro CDP, California",2868,607,2718,601,150,92
1600000US0655380,Palos Verdes Estates city,"Palos Verdes Estates city, California",13329,47,11767,453,1562,450
1600000US0655422,Palo Verde CDP,"Palo Verde CDP, California",78,94,20,32,58,91
1600000US0655506,Panorama Heights CDP,"Panorama Heights CDP, California",51,26,45,26,6,6
1600000US0655520,Paradise town,"Paradise town, California",17136,150,11865,938,5271,919
1600000US0655528,Paradise CDP,"Paradise CDP, California",168,117,135,105,33,49
1600000US0655604,Paradise Park CDP,"Paradise Park CDP, California",468,306,458,306,10,16
1600000US0655618,Paramount city,"Paramount city, California",53638,158,23093,1833,30545,1811
1600000US0655728,Parklawn CDP,"Parklawn CDP, California",1844,862,1176,569,668,737
1600000US0655751,Parksdale CDP,"Parksdale CDP, California",2725,489,1470,404,1255,418
1600000US0655800,Parkway CDP,"Parkway CDP, California",16203,1410,7324,963,8879,1115
1600000US0655842,Parkwood CDP,"Parkwood CDP, California",2394,715,1642,653,752,514
1600000US0655856,Parlier city,"Parlier city, California",15645,19,7039,986,8606,985
1600000US0656000,Pasadena city,"Pasadena city, California",138146,574,60139,2007,78007,1985
1600000US0656028,Pasatiempo CDP,"Pasatiempo CDP, California",1226,344,1040,329,186,173
1600000US0656042,Paskenta CDP,"Paskenta CDP, California",50,31,27,18,23,27
1600000US0656112,Patterson city,"Patterson city, California",22281,29,16347,1260,5934,1266
1600000US0656120,Patterson Tract CDP,"Patterson Tract CDP, California",2003,563,1532,515,471,368
1600000US0656140,Patton Village CDP,"Patton Village CDP, California",635,206,375,158,260,132
1600000US0656182,Paxton CDP,"Paxton CDP, California",0,13,0,13,0,13
1600000US0656196,Paynes Creek CDP,"Paynes Creek CDP, California",47,41,47,41,0,13
1600000US0656294,Pearsonville CDP,"Pearsonville CDP, California",0,13,0,13,0,13
1600000US0656476,Penngrove CDP,"Penngrove CDP, California",2368,569,1738,571,630,270
1600000US0656518,Penn Valley CDP,"Penn Valley CDP, California",1059,481,780,486,279,194
1600000US0656546,Penryn CDP,"Penryn CDP, California",878,292,775,287,103,68
1600000US0656598,Pepperdine University CDP,"Pepperdine University CDP, California",355,124,292,116,63,51
1600000US0656700,Perris city,"Perris city, California",77411,216,51966,2590,25445,2613
1600000US0656756,Pescadero CDP,"Pescadero CDP, California",418,303,107,114,311,279
1600000US0656784,Petaluma city,"Petaluma city, California",60193,209,39287,1410,20906,1439
1600000US0656786,Petaluma Center CDP,"Petaluma Center CDP, California",740,334,0,13,740,334
1600000US0656798,Peters CDP,"Peters CDP, California",472,194,456,196,16,23
1600000US0656826,Phelan CDP,"Phelan CDP, California",18979,2893,14407,2264,4572,1661
1600000US0656854,Phillipsville CDP,"Phillipsville CDP, California",102,92,29,47,73,89
1600000US0656868,Philo CDP,"Philo CDP, California",149,124,18,20,131,124
1600000US0656870,Phoenix Lake CDP,"Phoenix Lake CDP, California",4820,759,3847,737,973,452
1600000US0656924,Pico Rivera city,"Pico Rivera city, California",62055,178,45317,1842,16738,1853
1600000US0656938,Piedmont city,"Piedmont city, California",11449,24,9980,567,1469,565
1600000US0657011,Pierpoint CDP,"Pierpoint CDP, California",42,60,42,60,0,13
1600000US0657036,Pike CDP,"Pike CDP, California",120,104,48,48,72,86
1600000US0657070,Pine Canyon CDP,"Pine Canyon CDP, California",2934,765,2594,763,340,269
1600000US0657134,Pine Flat CDP,"Pine Flat CDP, California",153,96,118,74,35,50
1600000US0657148,Pine Grove CDP,"Pine Grove CDP, California",2070,407,1633,379,437,280
1600000US0657204,Pine Hills CDP,"Pine Hills CDP, California",3524,808,2833,729,691,352
1600000US0657240,Pine Mountain Club CDP,"Pine Mountain Club CDP, California",2011,568,1721,563,290,164
1600000US0657244,Pine Mountain Lake CDP,"Pine Mountain Lake CDP, California",2790,544,2461,545,329,178
1600000US0657260,Pine Valley CDP,"Pine Valley CDP, California",1611,437,1271,421,340,231
1600000US0657288,Pinole city,"Pinole city, California",19252,71,13722,880,5530,883
1600000US0657302,Piñon Hills CDP,"Piñon Hills CDP, California",6937,890,5196,1037,1741,648
1600000US0657330,Pioneer CDP,"Pioneer CDP, California",1224,313,1020,277,204,221
1600000US0657372,Piru CDP,"Piru CDP, California",2126,366,1156,263,970,279
1600000US0657414,Pismo Beach city,"Pismo Beach city, California",8037,27,6241,367,1796,368
1600000US0657456,Pittsburg city,"Pittsburg city, California",71354,113,42349,2065,29005,2084
1600000US0657512,Pixley CDP,"Pixley CDP, California",4322,874,2266,1018,2056,702
1600000US0657526,Placentia city,"Placentia city, California",51525,177,33183,1633,18342,1639
1600000US0657540,Placerville city,"Placerville city, California",10287,215,6486,762,3801,703
1600000US0657568,Plainview CDP,"Plainview CDP, California",610,160,290,121,320,145
1600000US0657582,Planada CDP,"Planada CDP, California",3984,584,2245,478,1739,554
1600000US0657666,Platina CDP,"Platina CDP, California",23,39,0,13,23,39
1600000US0657764,Pleasant Hill city,"Pleasant Hill city, California",34500,239,23973,1188,10527,1180
1600000US0657792,Pleasanton city,"Pleasanton city, California",79673,116,57085,1552,22588,1539
1600000US0657825,Pleasure Point CDP,"Pleasure Point CDP, California",6173,877,3931,582,2242,811
1600000US0657828,Plumas Eureka CDP,"Plumas Eureka CDP, California",358,91,281,84,77,48
1600000US0657829,Plumas Lake CDP,"Plumas Lake CDP, California",7665,798,6174,727,1491,681
1600000US0657834,Plymouth city,"Plymouth city, California",1031,233,701,207,330,122
1600000US0657876,Point Arena city,"Point Arena city, California",407,154,187,96,220,112
1600000US0657960,Point Reyes Station CDP,"Point Reyes Station CDP, California",210,100,150,91,60,51
1600000US0658030,Pollock Pines CDP,"Pollock Pines CDP, California",6456,747,4853,631,1603,540
1600000US0658072,Pomona city,"Pomona city, California",146819,533,78558,3034,68261,2979
1600000US0658134,Ponderosa CDP,"Ponderosa CDP, California",52,59,52,59,0,13
1600000US0658191,Poplar-Cotton Center CDP,"Poplar-Cotton Center CDP, California",1840,468,737,269,1103,374
1600000US0658226,Port Costa CDP,"Port Costa CDP, California",242,173,60,97,182,145
1600000US0658240,Porterville city,"Porterville city, California",57698,249,29257,1987,28441,2010
1600000US0658296,Port Hueneme city,"Port Hueneme city, California",20952,295,10450,1368,10502,1342
1600000US0658352,Portola city,"Portola city, California",1717,319,952,255,765,242
1600000US0658380,Portola Valley town,"Portola Valley town, California",4524,52,3733,368,791,371
1600000US0658422,Posey CDP,"Posey CDP, California",0,13,0,13,0,13
1600000US0658436,Poso Park CDP,"Poso Park CDP, California",3,5,3,5,0,13
1600000US0658456,Post Mountain CDP,"Post Mountain CDP, California",82,72,47,56,35,49
1600000US0658471,Potomac Park CDP,"Potomac Park CDP, California",10833,1683,3522,808,7311,1647
1600000US0658478,Potrero CDP,"Potrero CDP, California",250,361,148,311,102,154
1600000US0658506,Potter Valley CDP,"Potter Valley CDP, California",351,134,249,120,102,67
1600000US0658520,Poway city,"Poway city, California",49153,246,39212,1046,9941,1034
1600000US0658618,Prattville CDP,"Prattville CDP, California",27,17,27,17,0,13
1600000US0658758,Princeton CDP,"Princeton CDP, California",337,147,169,70,168,147
1600000US0658814,Proberta CDP,"Proberta CDP, California",36,55,36,55,0,13
1600000US0658870,Prunedale CDP,"Prunedale CDP, California",20533,2014,15612,1554,4921,1817
1600000US0658940,Pumpkin Center CDP,"Pumpkin Center CDP, California",169,160,35,44,134,163
1600000US0659052,Quartz Hill CDP,"Quartz Hill CDP, California",10374,1009,7097,853,3277,772
1600000US0659080,Quincy CDP,"Quincy CDP, California",1653,479,849,424,804,295
1600000US0659115,Rackerby CDP,"Rackerby CDP, California",193,94,98,45,95,92
1600000US0659220,Rail Road Flat CDP,"Rail Road Flat CDP, California",97,76,67,62,30,45
1600000US0659248,Rainbow CDP,"Rainbow CDP, California",2117,357,1653,362,464,195
1600000US0659290,Raisin City CDP,"Raisin City CDP, California",377,152,165,119,212,158
1600000US0659346,Ramona CDP,"Ramona CDP, California",21362,1998,13218,1133,8144,1546
1600000US0659426,Rancho Calaveras CDP,"Rancho Calaveras CDP, California",6296,926,5121,999,1175,475
1600000US0659444,Rancho Cordova city,"Rancho Cordova city, California",73862,153,41686,1754,32176,1793
1600000US0659451,Rancho Cucamonga city,"Rancho Cucamonga city, California",174978,1375,112129,3478,62849,3000
1600000US0659500,Rancho Mirage city,"Rancho Mirage city, California",18423,61,14293,842,4130,833
1600000US0659503,Rancho Mission Viejo CDP,"Rancho Mission Viejo CDP, California",7816,1274,6427,1080,1389,532
1600000US0659506,Rancho Murieta CDP,"Rancho Murieta CDP, California",5682,903,5249,909,433,266
1600000US0659514,Rancho Palos Verdes city,"Rancho Palos Verdes city, California",41143,141,30513,1330,10630,1362
1600000US0659550,Rancho San Diego CDP,"Rancho San Diego CDP, California",21417,1731,15682,1639,5735,978
1600000US0659584,Rancho Santa Fe CDP,"Rancho Santa Fe CDP, California",2657,542,2064,500,593,290
1600000US0659587,Rancho Santa Margarita city,"Rancho Santa Margarita city, California",48280,57,36236,1283,12044,1288
1600000US0659604,Rancho Tehama Reserve CDP,"Rancho Tehama Reserve CDP, California",1750,589,1134,433,616,432
1600000US0659668,Randsburg CDP,"Randsburg CDP, California",99,95,99,95,0,13
1600000US0659892,Red Bluff city,"Red Bluff city, California",13634,192,5762,828,7872,809
1600000US0659896,Red Corral CDP,"Red Corral CDP, California",1463,386,1127,323,336,306
1600000US0659906,Redcrest CDP,"Redcrest CDP, California",19,30,19,30,0,13
1600000US0659920,Redding city,"Redding city, California",89554,551,49906,1638,39648,1778
1600000US0659962,Redlands city,"Redlands city, California",68898,349,40964,2374,27934,2330
1600000US0660018,Redondo Beach city,"Redondo Beach city, California",66498,142,37676,1928,28822,1961
1600000US0660088,Redway CDP,"Redway CDP, California",1315,601,1194,572,121,158
1600000US0660102,Redwood City city,"Redwood City city, California",82982,413,39158,2194,43824,2209
1600000US0660214,Redwood Valley CDP,"Redwood Valley CDP, California",1812,541,1151,457,661,432
1600000US0660242,Reedley city,"Reedley city, California",25376,156,14355,1361,11021,1397
1600000US0660279,Reliez Valley CDP,"Reliez Valley CDP, California",3278,516,2946,510,332,206
1600000US0660370,Rexland Acres CDP,"Rexland Acres CDP, California",3463,384,1824,450,1639,409
1600000US0660466,Rialto city,"Rialto city, California",102995,263,66102,2442,36893,2434
1600000US0660592,Richfield CDP,"Richfield CDP, California",341,179,199,97,142,137
1600000US0660606,Richgrove CDP,"Richgrove CDP, California",2098,348,1226,386,872,204
1600000US0660620,Richmond city,"Richmond city, California",108691,237,57322,2536,51369,2508
1600000US0660662,Richvale CDP,"Richvale CDP, California",157,199,157,199,0,13
1600000US0660704,Ridgecrest city,"Ridgecrest city, California",28706,56,18011,1348,10695,1352
1600000US0660705,Ridgecrest Heights CDP,"Ridgecrest Heights CDP, California",193,134,94,69,99,116
1600000US0660706,Ridgemark CDP,"Ridgemark CDP, California",2549,230,1978,291,571,193
1600000US0660900,Rio Dell city,"Rio Dell city, California",3358,41,2138,380,1220,384
1600000US0660928,Rio del Mar CDP,"Rio del Mar CDP, California",9704,935,7291,898,2413,575
1600000US0660942,Rio Linda CDP,"Rio Linda CDP, California",16032,1343,11266,1187,4766,870
1600000US0660970,Rio Oso CDP,"Rio Oso CDP, California",414,143,359,141,55,31
1600000US0660984,Rio Vista city,"Rio Vista city, California",9402,21,7623,667,1779,667
1600000US0661012,Ripley CDP,"Ripley CDP, California",460,210,206,139,254,154
1600000US0661026,Ripon city,"Ripon city, California",15970,99,11191,925,4779,936
1600000US0661068,Riverbank city,"Riverbank city, California",24419,169,16683,1166,7736,1154
1600000US0661096,Riverdale CDP,"Riverdale CDP, California",2727,471,1476,499,1251,491
1600000US0661106,Riverdale Park CDP,"Riverdale Park CDP, California",1393,770,187,257,1206,670
1600000US0661108,Rivergrove CDP,"Rivergrove CDP, California",51,46,36,44,15,25
1600000US0661124,River Pines CDP,"River Pines CDP, California",420,295,365,294,55,61
1600000US0662000,Riverside city,"Riverside city, California",311669,3450,177636,4747,134033,4656
1600000US0662168,Robbins CDP,"Robbins CDP, California",428,165,239,134,189,113
1600000US0662200,Robinson Mill CDP,"Robinson Mill CDP, California",48,29,29,25,19,27
1600000US0662364,Rocklin city,"Rocklin city, California",66098,618,46460,1565,19638,1407
1600000US0662490,Rodeo CDP,"Rodeo CDP, California",9980,866,6182,833,3798,681
1600000US0662496,Rodriguez Camp CDP,"Rodriguez Camp CDP, California",61,66,0,13,61,66
1600000US0662546,Rohnert Park city,"Rohnert Park city, California",42496,51,22334,1469,20162,1459
1600000US0662602,Rolling Hills city,"Rolling Hills city, California",1439,241,1369,236,70,58
1600000US0662625,Rolling Hills CDP,"Rolling Hills CDP, California",706,177,706,177,0,13
1600000US0662644,Rolling Hills Estates city,"Rolling Hills Estates city, California",8025,37,7483,240,542,235
1600000US0662700,Rollingwood CDP,"Rollingwood CDP, California",3598,669,2086,789,1512,420
1600000US0662756,Romoland CDP,"Romoland CDP, California",2755,878,2364,891,391,360
1600000US0662826,Rosamond CDP,"Rosamond CDP, California",20248,1843,14161,1687,6087,1171
1600000US0662854,Rosedale CDP,"Rosedale CDP, California",18989,1691,15529,1342,3460,1129
1600000US0662860,Rose Hills CDP,"Rose Hills CDP, California",2619,341,2510,331,109,80
1600000US0662896,Rosemead city,"Rosemead city, California",53279,208,25914,1552,27365,1557
1600000US0662910,Rosemont CDP,"Rosemont CDP, California",23509,1438,12657,1182,10852,1251
1600000US0662938,Roseville city,"Roseville city, California",137863,197,97443,1999,40420,2008
1600000US0662980,Ross town,"Ross town, California",2385,356,1892,343,493,229
1600000US0663050,Rossmoor CDP,"Rossmoor CDP, California",11916,1334,10068,1314,1848,540
1600000US0663106,Rough and Ready CDP,"Rough and Ready CDP, California",511,292,260,153,251,256
1600000US0663134,Round Mountain CDP,"Round Mountain CDP, California",100,41,78,36,22,27
1600000US0663148,Round Valley CDP,"Round Valley CDP, California",325,88,96,54,229,76
1600000US0663168,Rouse CDP,"Rouse CDP, California",1684,499,735,402,949,417
1600000US0663218,Rowland Heights CDP,"Rowland Heights CDP, California",49732,1914,32907,2014,16825,1321
1600000US0663302,Rumsey CDP,"Rumsey CDP, California",107,109,100,110,7,12
1600000US0663316,Running Springs CDP,"Running Springs CDP, California",4410,716,3045,682,1365,440
1600000US0663386,Ruth CDP,"Ruth CDP, California",213,85,187,80,26,48
1600000US0663400,Rutherford CDP,"Rutherford CDP, California",100,94,20,17,80,91
1600000US0664000,Sacramento city,"Sacramento city, California",494338,872,258677,5991,235661,6099
1600000US0664056,Sage CDP,"Sage CDP, California",2792,704,2510,632,282,287
1600000US0664140,St. Helena city,"St. Helena city, California",5971,28,3884,361,2087,361
1600000US0664210,Salida CDP,"Salida CDP, California",15235,1646,10676,1585,4559,1658
1600000US0664224,Salinas city,"Salinas city, California",154634,284,70224,3184,84410,3165
1600000US0664252,Salmon Creek CDP,"Salmon Creek CDP, California",20,29,20,29,0,13
1600000US0664294,Salton City CDP,"Salton City CDP, California",5975,870,4287,661,1688,822
1600000US0664308,Salton Sea Beach CDP,"Salton Sea Beach CDP, California",295,182,211,150,84,106
1600000US0664378,Salyer CDP,"Salyer CDP, California",403,147,175,95,228,162
1600000US0664392,Samoa CDP,"Samoa CDP, California",211,107,0,13,211,107
1600000US0664420,San Andreas CDP,"San Andreas CDP, California",3553,998,1559,744,1994,830
1600000US0664434,San Anselmo town,"San Anselmo town, California",12542,62,9220,571,3322,568
1600000US0664462,San Antonio Heights CDP,"San Antonio Heights CDP, California",3091,479,2540,463,551,290
1600000US0664476,San Ardo CDP,"San Ardo CDP, California",628,236,176,183,452,194
1600000US0665000,San Bernardino city,"San Bernardino city, California",205996,950,103428,3830,102568,3885
1600000US0665028,San Bruno city,"San Bruno city, California",44194,212,28101,1568,16093,1531
1600000US0665042,San Buenaventura (Ventura) city,"San Buenaventura (Ventura) city, California",106503,226,60852,2585,45651,2602
1600000US0665070,San Carlos city,"San Carlos city, California",29520,59,21819,795,7701,802
1600000US0665084,San Clemente city,"San Clemente city, California",64596,146,44168,1815,20428,1819
1600000US0665112,Sand City city,"Sand City city, California",320,86,43,20,277,85
1600000US0666000,San Diego city,"San Diego city, California",1376865,2071,682559,8541,694306,9121
1600000US0666004,San Diego Country Estates CDP,"San Diego Country Estates CDP, California",9734,975,7941,795,1793,794
1600000US0666070,San Dimas city,"San Dimas city, California",33013,326,23670,1210,9343,1200
1600000US0666140,San Fernando city,"San Fernando city, California",24133,64,13942,1264,10191,1257
1600000US0667000,San Francisco city,"San Francisco city, California",854615,1770,374451,5830,480164,5695
1600000US0667042,San Gabriel city,"San Gabriel city, California",39422,201,19180,1399,20242,1418
1600000US0667056,Sanger city,"Sanger city, California",26576,780,16136,1322,10440,1239
1600000US0667070,San Geronimo CDP,"San Geronimo CDP, California",176,110,160,118,16,28
1600000US0667112,San Jacinto city,"San Jacinto city, California",48587,106,31254,2321,17333,2309
1600000US0667126,San Joaquin city,"San Joaquin city, California",4025,22,1874,400,2151,400
1600000US0668000,San Jose city,"San Jose city, California",1015442,927,585819,6956,429623,6954
1600000US0668014,San Juan Bautista city,"San Juan Bautista city, California",2086,424,835,218,1251,388
1600000US0668028,San Juan Capistrano city,"San Juan Capistrano city, California",35830,124,25511,1734,10319,1736
1600000US0668084,San Leandro city,"San Leandro city, California",90007,139,51940,2330,38067,2321
1600000US0668112,San Lorenzo CDP,"San Lorenzo CDP, California",29863,1607,19634,1707,10229,1320
1600000US0668140,San Lucas CDP,"San Lucas CDP, California",415,216,189,116,226,162
1600000US0668154,San Luis Obispo city,"San Luis Obispo city, California",45965,392,18146,1144,27819,1197
1600000US0668196,San Marcos city,"San Marcos city, California",95259,220,58370,2515,36889,2532
1600000US0668224,San Marino city,"San Marino city, California",12909,51,10118,1278,2791,1276
1600000US0668238,San Martin CDP,"San Martin CDP, California",6278,793,4540,763,1738,577
1600000US0668252,San Mateo city,"San Mateo city, California",102085,360,54284,1944,47801,1956
1600000US0668263,San Miguel CDP (Contra Costa County),"San Miguel CDP (Contra Costa County), California",3245,593,3086,600,159,99
1600000US0668266,San Miguel CDP (San Luis Obispo County),"San Miguel CDP (San Luis Obispo County), California",2518,681,1212,332,1306,650
1600000US0668294,San Pablo city,"San Pablo city, California",30515,166,12409,1118,18106,1118
1600000US0668308,San Pasqual CDP,"San Pasqual CDP, California",2038,252,1109,242,929,259
1600000US0668364,San Rafael city,"San Rafael city, California",57082,357,27203,1447,29879,1380
1600000US0668378,San Ramon city,"San Ramon city, California",81237,77,62328,1538,18909,1543
1600000US0668434,San Simeon CDP,"San Simeon CDP, California",534,252,111,58,423,248
1600000US0669000,Santa Ana city,"Santa Ana city, California",328060,637,151212,4545,176848,4496
1600000US0669070,Santa Barbara city,"Santa Barbara city, California",89527,333,36602,2111,52925,2070
1600000US0669084,Santa Clara city,"Santa Clara city, California",121499,584,55227,2262,66272,2205
1600000US0669088,Santa Clarita city,"Santa Clarita city, California",210549,313,147703,3330,62846,3389
1600000US0669112,Santa Cruz city,"Santa Cruz city, California",54657,598,26527,1543,28130,1624
1600000US0669154,Santa Fe Springs city,"Santa Fe Springs city, California",17449,59,11768,822,5681,823
1600000US0669182,Santa Margarita CDP,"Santa Margarita CDP, California",1025,442,565,345,460,368
1600000US0669196,Santa Maria city,"Santa Maria city, California",104436,335,48851,2683,55585,2698
1600000US0670000,Santa Monica city,"Santa Monica city, California",89974,305,30125,1512,59849,1533
1600000US0670028,Santa Nella CDP,"Santa Nella CDP, California",1981,616,1357,464,624,524
1600000US0670042,Santa Paula city,"Santa Paula city, California",30161,95,15180,1268,14981,1269
1600000US0670098,Santa Rosa city,"Santa Rosa city, California",175133,492,95309,3484,79824,3445
1600000US0670130,Santa Rosa Valley CDP,"Santa Rosa Valley CDP, California",2721,464,2660,467,61,56
1600000US0670140,Santa Susana CDP,"Santa Susana CDP, California",918,202,755,198,163,111
1600000US0670154,Santa Venetia CDP,"Santa Venetia CDP, California",3648,529,2854,504,794,424
1600000US0670182,Santa Ynez CDP,"Santa Ynez CDP, California",4724,871,3351,776,1373,674
1600000US0670224,Santee city,"Santee city, California",55446,886,39014,1445,16432,1226
1600000US0670266,Saranap CDP,"Saranap CDP, California",5991,765,4201,613,1790,585
1600000US0670280,Saratoga city,"Saratoga city, California",30869,134,26612,808,4257,812
1600000US0670322,Saticoy CDP,"Saticoy CDP, California",1739,825,690,346,1049,801
1600000US0670336,Sattley CDP,"Sattley CDP, California",73,49,73,49,0,13
1600000US0670364,Sausalito city,"Sausalito city, California",7155,22,4143,445,3012,443
1600000US0670518,Scotia CDP,"Scotia CDP, California",490,216,21,34,469,214
1600000US0670588,Scotts Valley city,"Scotts Valley city, California",11851,76,9172,602,2679,604
1600000US0670644,Seacliff CDP,"Seacliff CDP, California",3580,657,2347,585,1233,307
1600000US0670686,Seal Beach city,"Seal Beach city, California",24029,180,18013,705,6016,696
1600000US0670712,Sea Ranch CDP,"Sea Ranch CDP, California",1156,210,914,204,242,105
1600000US0670728,Searles Valley CDP,"Searles Valley CDP, California",1647,251,741,215,906,261
1600000US0670742,Seaside city,"Seaside city, California",32777,278,11971,933,20806,986
1600000US0670770,Sebastopol city,"Sebastopol city, California",7546,43,4197,535,3349,532
1600000US0670798,Seeley CDP,"Seeley CDP, California",1847,517,1139,487,708,245
1600000US0670882,Selma city,"Selma city, California",24271,93,12144,1746,12127,1742
1600000US0670966,Sequoia Crest CDP,"Sequoia Crest CDP, California",39,59,39,59,0,13
1600000US0671000,Sereno del Mar CDP,"Sereno del Mar CDP, California",57,50,11,17,46,47
1600000US0671078,Seville CDP,"Seville CDP, California",449,236,243,169,206,136
1600000US0671106,Shafter city,"Shafter city, California",18931,229,10494,1050,8437,1030
1600000US0671134,Shandon CDP,"Shandon CDP, California",1054,406,812,404,242,142
1600000US0671218,Shasta CDP,"Shasta CDP, California",1639,398,1390,354,249,213
1600000US0671225,Shasta Lake city,"Shasta Lake city, California",10206,30,6576,509,3630,511
1600000US0671246,Shaver Lake CDP,"Shaver Lake CDP, California",438,102,414,101,24,12
1600000US0671362,Shell Ridge CDP,"Shell Ridge CDP, California",1081,341,970,305,111,147
1600000US0671372,Shelter Cove CDP,"Shelter Cove CDP, California",863,253,608,208,255,235
1600000US0671414,Sheridan CDP,"Sheridan CDP, California",1120,455,612,345,508,374
1600000US0671554,Shingle Springs CDP,"Shingle Springs CDP, California",3651,611,2555,477,1096,440
1600000US0671568,Shingletown CDP,"Shingletown CDP, California",2291,495,2086,480,205,185
1600000US0671680,Shoshone CDP,"Shoshone CDP, California",18,16,0,13,18,16
1600000US0671774,Sierra Brooks CDP,"Sierra Brooks CDP, California",441,192,441,192,0,13
1600000US0671778,Sierra City CDP,"Sierra City CDP, California",84,45,84,45,0,13
1600000US0671806,Sierra Madre city,"Sierra Madre city, California",10824,39,7080,824,3744,824
1600000US0671834,Sierra Village CDP,"Sierra Village CDP, California",226,173,32,51,194,163
1600000US0671848,Sierraville CDP,"Sierraville CDP, California",161,101,62,46,99,104
1600000US0671876,Signal Hill city,"Signal Hill city, California",11374,71,4799,868,6575,868
1600000US0671918,Silverado CDP,"Silverado CDP, California",740,158,646,150,94,74
1600000US0671927,Silverado Resort CDP,"Silverado Resort CDP, California",1171,321,1034,308,137,84
1600000US0671932,Silver City CDP,"Silver City CDP, California",0,13,0,13,0,13
1600000US0671964,Silver Lakes CDP,"Silver Lakes CDP, California",6050,1150,4883,1279,1167,582
1600000US0672016,Simi Valley city,"Simi Valley city, California",125000,160,91811,1651,33189,1677
1600000US0672086,Sisquoc CDP,"Sisquoc CDP, California",169,64,106,54,63,37
1600000US0672156,Sky Valley CDP,"Sky Valley CDP, California",2245,458,1834,321,411,379
1600000US0672184,Sleepy Hollow CDP,"Sleepy Hollow CDP, California",2230,499,2004,411,226,288
1600000US0672282,Smartsville CDP,"Smartsville CDP, California",485,224,379,239,106,117
1600000US0672338,Smith Corner CDP,"Smith Corner CDP, California",413,365,40,68,373,361
1600000US0672380,Smith River CDP,"Smith River CDP, California",670,340,609,349,61,78
1600000US0672408,Snelling CDP,"Snelling CDP, California",115,55,86,55,29,24
1600000US0672478,Soda Bay CDP,"Soda Bay CDP, California",708,285,639,269,69,82
1600000US0672492,Soda Springs CDP,"Soda Springs CDP, California",46,69,46,69,0,13
1600000US0672506,Solana Beach city,"Solana Beach city, California",13301,34,8464,834,4837,831
1600000US0672520,Soledad city,"Soledad city, California",17070,464,10007,1247,7063,1250
1600000US0672576,Solvang city,"Solvang city, California",5586,28,3553,441,2033,437
1600000US0672632,Somis CDP,"Somis CDP, California",1189,275,1008,279,181,100
1600000US0672646,Sonoma city,"Sonoma city, California",10856,115,6852,655,4004,632
1600000US0672654,Sonoma State University CDP,"Sonoma State University CDP, California",0,13,0,13,0,13
1600000US0672674,Sonora city,"Sonora city, California",4570,82,2845,365,1725,372
1600000US0672688,Soquel CDP,"Soquel CDP, California",10641,1243,7162,1108,3479,763
1600000US0672772,Soulsbyville CDP,"Soulsbyville CDP, California",2063,547,1820,514,243,174
1600000US0672954,South Dos Palos CDP,"South Dos Palos CDP, California",1167,497,543,404,624,428
1600000US0672996,South El Monte city,"South El Monte city, California",20744,77,10325,796,10419,798
1600000US0673080,South Gate city,"South Gate city, California",94837,73,45981,2193,48856,2190
1600000US0673108,South Lake Tahoe city,"South Lake Tahoe city, California",22222,106,8973,940,13249,932
1600000US0673167,South Monrovia Island CDP,"South Monrovia Island CDP, California",6423,929,4001,812,2422,660
1600000US0673178,South Oroville CDP,"South Oroville CDP, California",2494,478,1349,403,1145,345
1600000US0673220,South Pasadena city,"South Pasadena city, California",25362,109,13724,903,11638,903
1600000US0673262,South San Francisco city,"South San Francisco city, California",66101,319,41067,1771,25034,1784
1600000US0673276,South San Gabriel CDP,"South San Gabriel CDP, California",8200,1207,5599,963,2601,1091
1600000US0673290,South San Jose Hills CDP,"South San Jose Hills CDP, California",19056,1431,13881,1286,5175,1371
1600000US0673388,South Taft CDP,"South Taft CDP, California",2120,584,947,444,1173,450
1600000US0673430,South Whittier CDP,"South Whittier CDP, California",58265,2647,37058,2678,21207,1706
1600000US0673554,Spaulding CDP,"Spaulding CDP, California",129,79,120,75,9,13
1600000US0673612,Spreckels CDP,"Spreckels CDP, California",373,225,250,199,123,150
1600000US0673654,Spring Garden CDP,"Spring Garden CDP, California",19,28,0,13,19,28
1600000US0673690,Spring Valley CDP (Lake County),"Spring Valley CDP (Lake County), California",1056,336,590,258,466,287
1600000US0673696,Spring Valley CDP (San Diego County),"Spring Valley CDP (San Diego County), California",31718,2304,19330,1792,12388,1747
1600000US0673700,Spring Valley Lake CDP,"Spring Valley Lake CDP, California",8408,1236,5918,1168,2490,931
1600000US0673710,Springville CDP,"Springville CDP, California",567,364,305,185,262,352
1600000US0673794,Squaw Valley CDP,"Squaw Valley CDP, California",3506,798,2683,739,823,619
1600000US0673815,Squirrel Mountain Valley CDP,"Squirrel Mountain Valley CDP, California",1146,482,969,492,177,159
1600000US0673868,Stallion Springs CDP,"Stallion Springs CDP, California",2996,759,2326,575,670,803
1600000US0673906,Stanford CDP,"Stanford CDP, California",7253,645,2540,508,4713,582
1600000US0673962,Stanton city,"Stanton city, California",38090,87,17577,1621,20513,1607
1600000US0674021,Stebbins CDP,"Stebbins CDP, California",963,324,732,225,231,256
1600000US0674130,Stevenson Ranch CDP,"Stevenson Ranch CDP, California",18980,1406,13596,1247,5384,1000
1600000US0674144,Stevinson CDP,"Stevinson CDP, California",196,141,190,141,6,10
1600000US0674172,Stinson Beach CDP,"Stinson Beach CDP, California",583,178,333,137,250,116
1600000US0674186,Stirling City CDP,"Stirling City CDP, California",300,226,29,32,271,223
1600000US0675000,Stockton city,"Stockton city, California",304537,640,153508,5066,151029,5070
1600000US0675122,Stones Landing CDP,"Stones Landing CDP, California",102,93,102,93,0,13
1600000US0675154,Stonyford CDP,"Stonyford CDP, California",71,32,55,27,16,17
1600000US0675252,Stratford CDP,"Stratford CDP, California",771,366,354,240,417,346
1600000US0675280,Strathmore CDP,"Strathmore CDP, California",3641,1493,1957,1456,1684,682
1600000US0675315,Strawberry CDP (Marin County),"Strawberry CDP (Marin County), California",4986,759,2276,354,2710,693
1600000US0675322,Strawberry CDP (Tuolumne County),"Strawberry CDP (Tuolumne County), California",0,13,0,13,0,13
1600000US0675592,Sugarloaf Saw Mill CDP,"Sugarloaf Saw Mill CDP, California",0,13,0,13,0,13
1600000US0675596,Sugarloaf Village CDP,"Sugarloaf Village CDP, California",8,10,8,10,0,13
1600000US0675630,Suisun City city,"Suisun City city, California",29331,73,18244,1230,11087,1229
1600000US0675672,Sultana CDP,"Sultana CDP, California",1336,318,301,221,1035,307
1600000US0675714,Summerland CDP,"Summerland CDP, California",745,283,544,230,201,153
1600000US0675994,Sunnyside CDP,"Sunnyside CDP, California",4551,618,3492,523,1059,413
1600000US0676015,Sunnyside-Tahoe City CDP,"Sunnyside-Tahoe City CDP, California",1572,414,1416,395,156,101
1600000US0676040,Sunny Slopes CDP,"Sunny Slopes CDP, California",68,49,68,49,0,13
1600000US0677000,Sunnyvale city,"Sunnyvale city, California",151594,295,71993,2386,79601,2411
1600000US0677042,Sunol CDP,"Sunol CDP, California",835,162,706,150,129,92
1600000US0677308,Sun Village CDP,"Sun Village CDP, California",14080,1993,8849,1277,5231,1610
1600000US0677364,Susanville city,"Susanville city, California",6371,444,2983,398,3388,384
1600000US0677378,Sutter CDP,"Sutter CDP, California",2789,326,2253,341,536,221
1600000US0677392,Sutter Creek city,"Sutter Creek city, California",2625,36,1481,281,1144,284
1600000US0677430,Swall Meadows CDP,"Swall Meadows CDP, California",390,160,390,160,0,13
1600000US0677574,Taft city,"Taft city, California",8341,354,4428,1025,3913,1015
1600000US0677588,Taft Heights CDP,"Taft Heights CDP, California",1509,346,538,238,971,340
1600000US0677595,Taft Mosswood CDP,"Taft Mosswood CDP, California",1060,300,543,220,517,253
1600000US0677700,Tahoe Vista CDP,"Tahoe Vista CDP, California",1233,336,927,275,306,202
1600000US0677728,Tahoma CDP,"Tahoma CDP, California",1039,274,599,181,440,219
1600000US0677784,Talmage CDP,"Talmage CDP, California",782,251,342,204,440,239
1600000US0677805,Tamalpais-Homestead Valley CDP,"Tamalpais-Homestead Valley CDP, California",12311,960,10014,1069,2297,541
1600000US0677860,Tancred CDP,"Tancred CDP, California",19,28,16,26,3,4
1600000US0677924,Tara Hills CDP,"Tara Hills CDP, California",4893,709,3386,719,1507,457
1600000US0677934,Tarina CDP,"Tarina CDP, California",0,13,0,13,0,13
1600000US0677960,Tarpey Village CDP,"Tarpey Village CDP, California",4213,805,3023,678,1190,487
1600000US0678008,Taylorsville CDP,"Taylorsville CDP, California",35,47,7,11,28,46
1600000US0678050,Tecopa CDP,"Tecopa CDP, California",212,75,186,73,26,20
1600000US0678092,Tehachapi city,"Tehachapi city, California",8453,273,5441,879,3012,836
1600000US0678106,Tehama city,"Tehama city, California",503,179,342,122,161,124
1600000US0678120,Temecula city,"Temecula city, California",113052,75,74453,2431,38599,2437
1600000US0678126,Temelec CDP,"Temelec CDP, California",1915,461,1812,471,103,67
1600000US0678138,Temescal Valley CDP,"Temescal Valley CDP, California",28413,1951,23307,1887,5106,1538
1600000US0678148,Temple City city,"Temple City city, California",35223,135,21914,1197,13309,1188
1600000US0678162,Templeton CDP,"Templeton CDP, California",7871,1062,6118,1010,1753,617
1600000US0678176,Tennant CDP,"Tennant CDP, California",21,15,21,15,0,13
1600000US0678232,Terminous CDP,"Terminous CDP, California",400,102,337,124,63,63
1600000US0678288,Terra Bella CDP,"Terra Bella CDP, California",2369,664,1295,548,1074,526
1600000US0678336,Teviston CDP,"Teviston CDP, California",903,391,162,179,741,390
1600000US0678456,Thermal CDP,"Thermal CDP, California",1366,600,842,472,524,373
1600000US0678470,Thermalito CDP,"Thermalito CDP, California",6467,670,4116,740,2351,720
1600000US0678568,Thornton CDP,"Thornton CDP, California",903,191,365,143,538,160
1600000US0678582,Thousand Oaks city,"Thousand Oaks city, California",125678,238,88144,2583,37534,2568
1600000US0678596,Thousand Palms CDP,"Thousand Palms CDP, California",8137,1904,5148,1300,2989,1490
1600000US0678638,Three Rivers CDP,"Three Rivers CDP, California",2695,541,1852,362,843,477
1600000US0678652,Three Rocks CDP,"Three Rocks CDP, California",97,94,97,94,0,13
1600000US0678666,Tiburon town,"Tiburon town, California",9136,39,6680,512,2456,513
1600000US0678715,Timber Cove CDP,"Timber Cove CDP, California",107,32,97,31,10,9
1600000US0678750,Tipton CDP,"Tipton CDP, California",3391,813,1389,395,2002,775
1600000US0678792,Tobin CDP,"Tobin CDP, California",0,13,0,13,0,13
1600000US0678890,Tomales CDP,"Tomales CDP, California",160,111,160,111,0,13
1600000US0678932,Tonyville CDP,"Tonyville CDP, California",236,173,65,57,171,194
1600000US0678949,Tooleville CDP,"Tooleville CDP, California",184,151,15,23,169,150
1600000US0678960,Topanga CDP,"Topanga CDP, California",8098,1347,6174,1241,1924,732
1600000US0679030,Topaz CDP,"Topaz CDP, California",369,304,336,324,33,58
1600000US0679529,Toro Canyon CDP,"Toro Canyon CDP, California",1908,428,1596,430,312,184
1600000US0680000,Torrance city,"Torrance city, California",142991,307,80539,2887,62452,2932
1600000US0680210,Trabuco Canyon CDP,"Trabuco Canyon CDP, California",1146,476,1059,470,87,94
1600000US0680238,Tracy city,"Tracy city, California",91203,95,56408,2077,34795,2064
1600000US0680266,Tranquillity CDP,"Tranquillity CDP, California",807,365,559,372,248,211
1600000US0680280,Traver CDP,"Traver CDP, California",702,218,418,195,284,98
1600000US0680364,Tres Pinos CDP,"Tres Pinos CDP, California",921,258,772,245,149,121
1600000US0680448,Trinidad city,"Trinidad city, California",348,99,207,83,141,71
1600000US0680476,Trinity Center CDP,"Trinity Center CDP, California",265,116,243,120,22,26
1600000US0680483,Trinity Village CDP,"Trinity Village CDP, California",248,114,201,104,47,47
1600000US0680515,Trona CDP,"Trona CDP, California",69,58,17,29,52,65
1600000US0680560,Trowbridge CDP,"Trowbridge CDP, California",196,65,196,65,0,13
1600000US0680588,Truckee town,"Truckee town, California",16666,37,13651,733,3015,733
1600000US0680644,Tulare city,"Tulare city, California",64198,130,36225,2073,27973,2091
1600000US0680686,Tulelake city,"Tulelake city, California",839,219,411,169,428,197
1600000US0680763,Tuolumne City CDP,"Tuolumne City CDP, California",1398,426,747,373,651,335
1600000US0680784,Tupman CDP,"Tupman CDP, California",134,60,85,53,49,35
1600000US0680812,Turlock city,"Turlock city, California",72103,153,39493,2036,32610,2040
1600000US0680854,Tustin city,"Tustin city, California",79848,383,39130,2024,40718,1955
1600000US0680882,Tuttle CDP,"Tuttle CDP, California",97,106,97,106,0,13
1600000US0680896,Tuttletown CDP,"Tuttletown CDP, California",770,343,434,216,336,296
1600000US0680952,Twain CDP,"Twain CDP, California",303,269,129,152,174,220
1600000US0680966,Twain Harte CDP,"Twain Harte CDP, California",2502,685,1860,657,642,321
1600000US0680994,Twentynine Palms city,"Twentynine Palms city, California",23388,735,6222,726,17166,820
1600000US0681048,Twin Lakes CDP (Mono County),"Twin Lakes CDP (Mono County), California",117,151,117,151,0,13
1600000US0681050,Twin Lakes CDP (Santa Cruz County),"Twin Lakes CDP (Santa Cruz County), California",5410,697,2400,429,3010,709
1600000US0681134,Ukiah city,"Ukiah city, California",15238,191,7938,870,7300,855
1600000US0681204,Union City city,"Union City city, California",74338,207,48803,1889,25535,1844
1600000US0681302,University of California-Davis CDP,"University of California-Davis CDP, California",4391,598,15,24,4376,602
1600000US0681312,University of California-Merced CDP,"University of California-Merced CDP, California",0,13,0,13,0,13
1600000US0681316,University of California-Santa Barbara CDP,"University of California-Santa Barbara CDP, California",1735,379,404,251,1331,280
1600000US0681344,Upland city,"Upland city, California",76672,190,42197,1813,34475,1850
1600000US0681358,Upper Lake CDP,"Upper Lake CDP, California",1232,495,1157,505,75,54
1600000US0681554,Vacaville city,"Vacaville city, California",92847,594,61917,1712,30930,1763
1600000US0681638,Valinda CDP,"Valinda CDP, California",22580,1677,17034,1605,5546,968
1600000US0681652,Vallecito CDP,"Vallecito CDP, California",132,93,98,78,34,55
1600000US0681666,Vallejo city,"Vallejo city, California",119774,241,70167,2452,49607,2450
1600000US0681708,Valle Vista CDP,"Valle Vista CDP, California",19065,1708,14251,1760,4814,877
1600000US0681722,Valley Acres CDP,"Valley Acres CDP, California",641,210,407,196,234,165
1600000US0681736,Valley Center CDP,"Valley Center CDP, California",11261,1467,9559,1413,1702,802
1600000US0681778,Valley Ford CDP,"Valley Ford CDP, California",0,13,0,13,0,13
1600000US0681792,Valley Home CDP,"Valley Home CDP, California",209,85,198,85,11,16
1600000US0681869,Valley Ranch CDP,"Valley Ranch CDP, California",38,62,38,62,0,13
1600000US0681890,Valley Springs CDP,"Valley Springs CDP, California",3890,751,2688,797,1202,480
1600000US0681925,Valley Wells CDP,"Valley Wells CDP, California",0,13,0,13,0,13
1600000US0681967,Val Verde CDP,"Val Verde CDP, California",3261,855,2672,810,589,219
1600000US0682072,Vandenberg AFB CDP,"Vandenberg AFB CDP, California",3205,510,0,13,3205,510
1600000US0682086,Vandenberg Village CDP,"Vandenberg Village CDP, California",7919,877,5972,758,1947,811
1600000US0682334,Verdi CDP,"Verdi CDP, California",154,82,145,83,9,17
1600000US0682422,Vernon city,"Vernon city, California",248,111,15,17,233,109
1600000US0682562,Victor CDP,"Victor CDP, California",420,290,196,193,224,233
1600000US0682590,Victorville city,"Victorville city, California",118758,867,65127,3905,53631,3932
1600000US0682667,View Park-Windsor Hills CDP,"View Park-Windsor Hills CDP, California",11505,1244,8923,1175,2582,749
1600000US0682744,Villa Park city,"Villa Park city, California",5822,45,5583,283,239,284
1600000US0682786,Vina CDP,"Vina CDP, California",117,76,87,67,30,45
1600000US0682815,Vincent CDP,"Vincent CDP, California",16379,1397,13291,1331,3088,950
1600000US0682842,Vine Hill CDP,"Vine Hill CDP, California",3228,441,2375,363,853,385
1600000US0682852,Vineyard CDP,"Vineyard CDP, California",39588,1835,29467,1715,10121,1892
1600000US0682929,Virginia Lakes CDP,"Virginia Lakes CDP, California",0,13,0,13,0,13
1600000US0682954,Visalia city,"Visalia city, California",131112,450,75784,3331,55328,3338
1600000US0682996,Vista city,"Vista city, California",98651,356,46917,2357,51734,2307
1600000US0683085,Vista Santa Rosa CDP,"Vista Santa Rosa CDP, California",2072,524,1990,527,82,55
1600000US0683094,Volcano CDP,"Volcano CDP, California",45,54,45,54,0,13
1600000US0683108,Volta CDP,"Volta CDP, California",133,123,34,40,99,112
1600000US0683262,Walker CDP,"Walker CDP, California",398,185,374,187,24,34
1600000US0683304,Wallace CDP,"Wallace CDP, California",721,356,721,356,0,13
1600000US0683332,Walnut city,"Walnut city, California",29711,46,23982,904,5729,914
1600000US0683346,Walnut Creek city,"Walnut Creek city, California",68808,250,44423,1368,24385,1367
1600000US0683374,Walnut Grove CDP,"Walnut Grove CDP, California",1288,392,682,278,606,290
1600000US0683402,Walnut Park CDP,"Walnut Park CDP, California",15939,1184,9427,1110,6512,1102
1600000US0683460,Warm Springs CDP,"Warm Springs CDP, California",1445,451,915,333,530,355
1600000US0683494,Warner Valley CDP,"Warner Valley CDP, California",0,13,0,13,0,13
1600000US0683542,Wasco city,"Wasco city, California",21965,363,14327,1269,7638,1222
1600000US0683570,Washington CDP,"Washington CDP, California",137,135,118,134,19,25
1600000US0683612,Waterford city,"Waterford city, California",8884,23,5703,976,3181,971
1600000US0683626,Waterloo CDP,"Waterloo CDP, California",902,515,181,114,721,500
1600000US0683668,Watsonville city,"Watsonville city, California",51979,226,22123,1834,29856,1811
1600000US0683724,Waukena CDP,"Waukena CDP, California",51,27,18,14,33,25
1600000US0683730,Wautec CDP,"Wautec CDP, California",15,16,8,9,7,13
1600000US0683766,Wawona CDP,"Wawona CDP, California",144,98,17,28,127,91
1600000US0683794,Weaverville CDP,"Weaverville CDP, California",3229,468,1634,387,1595,420
1600000US0683850,Weed city,"Weed city, California",2528,96,751,159,1777,187
1600000US0683863,Weedpatch CDP,"Weedpatch CDP, California",2879,595,1125,461,1754,436
1600000US0683906,Weitchpec CDP,"Weitchpec CDP, California",58,45,49,47,9,9
1600000US0683948,Weldon CDP,"Weldon CDP, California",2160,613,1515,568,645,356
1600000US0684004,Weott CDP,"Weott CDP, California",124,116,124,116,0,13
1600000US0684116,West Athens CDP,"West Athens CDP, California",9526,1195,6160,1052,3366,831
1600000US0684120,West Bishop CDP,"West Bishop CDP, California",2553,286,2262,244,291,173
1600000US0684144,West Carson CDP,"West Carson CDP, California",21887,1503,16138,1714,5749,1020
1600000US0684200,West Covina city,"West Covina city, California",104894,244,68057,2212,36837,2213
1600000US0684345,West Goshen CDP,"West Goshen CDP, California",674,478,324,389,350,294
1600000US0684385,Westhaven-Moonstone CDP,"Westhaven-Moonstone CDP, California",1302,309,904,218,398,287
1600000US0684410,West Hollywood city,"West Hollywood city, California",35327,58,7088,837,28239,836
1600000US0684438,Westlake Village city,"Westlake Village city, California",8130,56,6663,427,1467,422
1600000US0684480,Westley CDP,"Westley CDP, California",689,364,183,221,506,308
1600000US0684536,West Menlo Park CDP,"West Menlo Park CDP, California",3707,415,2944,442,763,261
1600000US0684550,Westminster city,"Westminster city, California",90554,110,49736,2061,40818,2076
1600000US0684578,West Modesto CDP,"West Modesto CDP, California",5514,982,2039,751,3475,801
1600000US0684592,Westmont CDP,"Westmont CDP, California",35052,2501,11191,1639,23861,1939
1600000US0684606,Westmorland city,"Westmorland city, California",2680,609,1118,512,1562,345
1600000US0684680,West Park CDP,"West Park CDP, California",1025,283,546,229,479,234
1600000US0684732,West Point CDP,"West Point CDP, California",640,364,586,362,54,51
1600000US0684774,West Puente Valley CDP,"West Puente Valley CDP, California",23504,1678,19043,1551,4461,1217
1600000US0684780,West Rancho Dominguez CDP,"West Rancho Dominguez CDP, California",21596,2022,16151,1802,5445,1113
1600000US0684816,West Sacramento city,"West Sacramento city, California",53116,353,30728,1767,22388,1782
1600000US0684863,Westside CDP,"Westside CDP, California",213,201,28,35,185,205
1600000US0684921,West Whittier-Los Nietos CDP,"West Whittier-Los Nietos CDP, California",26025,1891,18819,1706,7206,1207
1600000US0684928,Westwood CDP,"Westwood CDP, California",1387,335,811,241,576,231
1600000US0685012,Wheatland city,"Wheatland city, California",3608,20,2327,398,1281,398
1600000US0685086,Whitehawk CDP,"Whitehawk CDP, California",37,41,37,41,0,13
1600000US0685208,Whitewater CDP,"Whitewater CDP, California",1154,360,759,327,395,218
1600000US0685222,Whitley Gardens CDP,"Whitley Gardens CDP, California",44,68,44,68,0,13
1600000US0685250,Whitmore CDP,"Whitmore CDP, California",402,147,383,147,19,22
1600000US0685292,Whittier city,"Whittier city, California",83117,256,50313,1938,32804,1939
1600000US0685446,Wildomar city,"Wildomar city, California",36003,105,26832,1397,9171,1393
1600000US0685551,Wilkerson CDP,"Wilkerson CDP, California",495,132,438,118,57,44
1600000US0685586,Williams city,"Williams city, California",5164,59,2915,514,2249,516
1600000US0685587,Williams Canyon CDP,"Williams Canyon CDP, California",108,135,108,135,0,13
1600000US0685600,Willits city,"Willits city, California",4810,87,1679,448,3131,457
1600000US0685614,Willowbrook CDP,"Willowbrook CDP, California",24218,1899,11128,1808,13090,1593
1600000US0685642,Willow Creek CDP,"Willow Creek CDP, California",1241,498,651,247,590,481
1600000US0685684,Willows city,"Willows city, California",5873,102,3306,485,2567,500
1600000US0685866,Wilsonia CDP,"Wilsonia CDP, California",0,13,0,13,0,13
1600000US0685880,Wilton CDP,"Wilton CDP, California",5192,869,4282,998,910,302
1600000US0685894,Winchester CDP,"Winchester CDP, California",2957,955,2461,840,496,528
1600000US0685922,Windsor town,"Windsor town, California",27570,45,21593,834,5977,839
1600000US0685992,Winter Gardens CDP,"Winter Gardens CDP, California",22625,1972,14317,1729,8308,1534
1600000US0686020,Winterhaven CDP,"Winterhaven CDP, California",151,81,131,77,20,31
1600000US0686034,Winters city,"Winters city, California",7276,21,4775,747,2501,750
1600000US0686076,Winton CDP,"Winton CDP, California",11619,1292,6608,1062,5011,1092
1600000US0686174,Wofford Heights CDP,"Wofford Heights CDP, California",1870,452,1160,377,710,394
1600000US0686216,Woodacre CDP,"Woodacre CDP, California",1464,390,1250,389,214,131
1600000US0686230,Woodbridge CDP,"Woodbridge CDP, California",3783,788,2763,690,1020,391
1600000US0686244,Woodcrest CDP,"Woodcrest CDP, California",18462,1851,16683,1626,1779,897
1600000US0686300,Woodlake city,"Woodlake city, California",7700,22,3956,601,3744,603
1600000US0686328,Woodland city,"Woodland city, California",58621,310,31616,1643,27005,1648
1600000US0686380,Woodlands CDP,"Woodlands CDP, California",2331,483,1985,469,346,267
1600000US0686440,Woodside town,"Woodside town, California",5593,61,4864,262,729,250
1600000US0686482,Woodville CDP,"Woodville CDP, California",1836,328,1172,264,664,216
1600000US0686489,Woodville Farm Labor Camp CDP,"Woodville Farm Labor Camp CDP, California",701,240,0,13,701,240
1600000US0686496,Woody CDP,"Woody CDP, California",67,45,67,45,0,13
1600000US0686594,Wrightwood CDP,"Wrightwood CDP, California",4362,804,3481,714,881,477
1600000US0686678,Yankee Hill CDP,"Yankee Hill CDP, California",256,103,213,96,43,50
1600000US0686720,Yermo CDP,"Yermo CDP, California",1082,632,443,449,639,447
1600000US0686734,Yettem CDP,"Yettem CDP, California",487,484,10,16,477,485
1600000US0686804,Yolo CDP,"Yolo CDP, California",196,144,185,143,11,17
1600000US0686832,Yorba Linda city,"Yorba Linda city, California",67791,121,56226,1500,11565,1510
1600000US0686878,Yosemite Lakes CDP,"Yosemite Lakes CDP, California",5303,585,4293,532,1010,394
1600000US0686912,Yosemite Valley CDP,"Yosemite Valley CDP, California",234,139,0,13,234,139
1600000US0686916,Yosemite West CDP,"Yosemite West CDP, California",26,21,26,21,0,13
1600000US0686930,Yountville city,"Yountville city, California",2453,210,1416,259,1037,236
1600000US0686944,Yreka city,"Yreka city, California",7539,83,4352,478,3187,473
1600000US0686972,Yuba City city,"Yuba City city, California",65836,258,35553,1599,30283,1615
1600000US0687042,Yucaipa city,"Yucaipa city, California",53873,239,38899,2016,14974,2001
1600000US0687056,Yucca Valley town,"Yucca Valley town, California",21502,148,13642,1105,7860,1102
1600000US0687090,Zayante CDP,"Zayante CDP, California",765,233,690,210,75,90